Kecamatan,Kode,Sekolah.7.12,Sekolah.13.15,Sekolah.16.18,Sekolah.Total,Tak.Sekolah.7.12,Tak.Sekolah.13.15,Tak.Sekolah.16.18,Total.Tak.Sekolah,Grand.Total,latitude,longitude
TEUPAH SELATAN,10,487,223,201,911,62,27,55,144,1055,2.316777992,96.48611481
SIMEULUE TIMUR,20,519,280,245,1044,18,20,75,113,1157,2.487851272,96.32700819
TEUPAH BARAT,21,521,251,209,981,22,19,47,88,1069,2.485748058,96.23294048
SIMEULUE TENGAH,30,607,306,244,1157,10,8,59,77,1234,2.618401599,96.02518503
TELUK DALAM,31,282,172,134,588,2,2,29,33,621,2.63694738,96.14482683
SALANG,40,758,377,316,1451,15,11,72,98,1549,2.676672614,95.86053908
SIMEULUE BARAT,50,1103,522,415,2040,22,22,110,154,2194,2.78276692,95.92013784
ALAFAN,51,587,248,192,1027,11,5,59,75,1102,2.805260242,95.7614773
PULAU BANYAK,10,289,146,86,521,10,12,32,54,575,2.154542266,97.25033322
PULAU BANYAK BARAT,11,288,111,60,459,44,25,58,127,586,,
SINGKIL,20,1083,557,320,1960,18,35,111,164,2124,2.33130195,97.8025295
SINGKIL UTARA,21,696,347,243,1286,11,26,71,108,1394,2.274402207,97.99569377
KUALA BARU,22,251,109,80,440,5,9,20,34,474,2.370522466,97.72805274
SIMPANG KANAN,30,900,503,287,1690,29,39,113,181,1871,2.429505551,98.03787093
GUNUNG MERIAH,31,1263,631,369,2263,68,57,156,281,2544,2.383762115,97.96209305
DANAU PARIS,32,366,182,90,638,47,26,55,128,766,2.315279654,98.11817103
SURO,33,843,405,284,1532,48,41,80,169,1701,2.530484897,98.02717892
SINGKOHOR,42,193,103,85,381,2,5,18,25,406,2.528740909,97.93618928
KOTA BAHARU,43,299,147,77,523,2,9,36,47,570,2.45952977,97.85339011
TRUMON,10,420,200,93,713,15,29,58,102,815,2.654803781,97.70859567
TRUMON TIMUR,11,518,248,121,887,20,51,99,170,1057,2.890080339,97.77576215
TRUMON TENGAH,12,334,162,73,569,10,17,67,94,663,,
BAKONGAN,20,131,55,36,222,3,6,25,34,256,2.999945239,97.53945895
BAKONGAN TIMUR,21,384,142,92,618,5,18,43,66,684,2.908171747,97.56143275
KOTA BAHAGIA,22,461,170,99,730,23,14,55,92,822,,
KLUET SELATAN,30,667,287,136,1090,12,30,88,130,1220,3.038233509,97.42078037
KLUET TIMUR,31,684,276,150,1110,15,23,91,129,1239,3.172187269,97.45625666
KLUET UTARA,40,948,379,251,1578,49,45,155,249,1827,3.125212471,97.34851923
PASIE RAJA,41,668,267,127,1062,22,20,92,134,1196,3.209761913,97.30037698
KLUET TENGAH,42,313,136,74,523,4,13,59,76,599,3.427534083,97.35630023
TAPAK TUAN,50,156,79,24,259,5,3,24,32,291,3.286233218,97.22867162
SAMA DUA,60,244,135,92,471,26,10,37,73,544,3.346928852,97.19315351
SAWANG,70,279,118,74,471,8,10,33,51,522,3.428995477,97.17464989
MEUKEK,80,701,268,185,1154,20,26,106,152,1306,3.563243786,97.17231736
LABUHAN HAJI,90,275,147,93,515,6,10,50,66,581,3.589929467,97.04779257
LABUHAN HAJI TIMUR,91,437,229,127,793,36,18,58,112,905,3.588711042,97.09212076
LABUHAN HAJI BARAT,92,697,290,172,1159,15,28,114,157,1316,3.620991225,97.0351062
LAWE ALAS,10,962,616,395,1973,14,19,102,135,2108,3.433633369,97.8192236
BABUL RAHMAD,11,664,400,208,1272,12,20,85,117,1389,3.11600225,97.81227534
TANOH ALAS,12,208,118,83,409,6,5,33,44,453,3.236757183,97.67032932
LAWE SIGALA-GALA,20,1054,576,324,1954,58,31,90,179,2133,3.351977571,97.93619596
BABUL MAKMUR,21,756,431,253,1440,22,32,76,130,1570,3.306763557,97.97347432
SEMADAM,22,678,318,223,1219,11,13,74,98,1317,3.388129956,97.88272141
LAUSER,23,581,250,98,929,27,48,101,176,1105,3.153901384,97.93045781
BAMBEL,30,624,372,235,1231,10,12,72,94,1325,3.439017352,97.90223562
BUKIT TUSAM,31,538,323,193,1054,10,8,68,86,1140,3.413641252,97.86856087
LAWE SUMUR,32,460,266,145,871,19,15,58,92,963,3.478404668,97.88482185
BABUSSALAM,40,562,350,195,1107,22,11,51,84,1191,3.488644561,97.80576981
LAWE BULAN,41,534,304,176,1014,7,13,56,76,1090,3.50124748,97.87070718
BADAR,50,339,199,119,657,9,7,29,45,702,3.589341045,97.82025963
DARUL HASANAH,51,979,531,317,1827,45,30,92,167,1994,3.522018425,97.56345933
KETAMBE,52,751,456,279,1486,15,23,80,118,1604,3.673916115,97.74049839
DELENG POKHKISEN,53,557,353,186,1096,4,5,59,68,1164,3.533371478,97.85691249
SERBA JADI,80,658,180,102,940,31,35,63,129,1069,4.470642685,97.47359782
SIMPANG JERNIH,81,458,122,56,636,19,39,71,129,765,4.369783488,97.69241568
PEUNARON,82,551,169,75,795,5,21,48,74,869,4.624602376,97.64975294
BIREM BAYEUN,90,1021,296,138,1455,19,62,161,242,1697,4.477707691,97.85775142
RANTAU SELAMAT,100,817,251,114,1182,21,73,143,237,1419,4.615660156,97.83304063
SUNGAI RAYA,101,775,210,126,1111,37,73,111,221,1332,4.666087888,97.88619015
PEUREULAK,110,2794,802,459,4055,50,147,408,605,4660,4.761937567,97.85685611
PEUREULAK TIMUR,111,911,239,113,1263,19,62,151,232,1495,4.716254474,97.89043799
PEUREULAK BARAT,112,1064,387,244,1695,21,48,144,213,1908,4.850705903,97.86022439
RANTO PEUREULAK,120,1256,399,190,1845,19,51,171,241,2086,4.76770722,97.7143154
IDI RAYEUK,130,2074,661,340,3075,44,115,373,532,3607,4.954884947,97.75984843
PEUDAWA,131,624,209,120,953,20,37,77,134,1087,4.884953694,97.81885212
BANDA ALAM,132,760,252,133,1145,6,21,115,142,1287,4.858698473,97.69136555
IDI TUNONG,133,908,289,198,1395,14,43,114,171,1566,4.915896188,97.72613548
DARUL IHSAN,134,469,153,99,721,7,12,51,70,791,4.903498341,97.75867067
IDI TIMUR,135,398,139,57,594,6,24,64,94,688,4.910746845,97.79402952
DARUL AMAN,140,1396,481,245,2122,55,83,222,360,2482,4.971796856,97.70170671
NURUSSALAM,150,1175,360,222,1757,29,44,181,254,2011,4.974656532,97.65944914
DARUL FALAH,151,202,66,41,309,1,8,28,37,346,5.010995242,97.64145095
JULOK,160,1543,480,272,2295,19,72,221,312,2607,5.03727372,97.60097273
INDRA MAKMUR,161,962,242,88,1292,12,54,131,197,1489,4.868559919,97.58385395
PANTE BIDARI,170,1913,504,286,2703,23,108,297,428,3131,4.874334238,97.48659694
SIMPANG ULIM,180,1313,446,232,1991,32,57,220,309,2300,5.107614691,97.57938021
MADAT,181,2008,621,315,2944,44,113,346,503,3447,5.16556196,97.51910017
LINGE,10,724,252,127,1103,51,51,131,233,1336,4.360696311,97.0704269
ATU LINTANG,11,403,140,66,609,7,21,56,84,693,4.437495604,96.78202271
JAGONG JEGET,12,525,210,121,856,10,24,59,93,949,4.381077708,96.73092897
BINTANG,20,902,377,245,1524,43,28,89,160,1684,4.539173746,97.14799071
LUT TAWAR,31,483,221,108,812,25,21,88,134,946,,
KEBAYAKAN,32,431,187,112,730,11,15,44,70,800,4.653345052,96.86917958
PEGASING,40,1055,406,218,1679,32,40,145,217,1896,4.492776992,96.72925817
BIES,41,272,112,55,439,10,10,45,65,504,4.611915987,96.79084062
BEBESEN,50,860,320,198,1378,28,23,100,151,1529,4.637734799,96.81193003
KUTE PANANG,51,335,123,54,512,20,12,56,88,600,4.688272338,96.77484617
SILIH NARA,60,1204,515,258,1977,67,50,155,272,2249,4.626625924,96.72627813
KETOL,61,380,128,52,560,14,25,81,120,680,4.822077619,96.61113039
CELALA,62,766,297,186,1249,29,60,123,212,1461,4.545869704,96.66876545
RUSIP ANTARA,63,570,194,73,837,63,54,88,205,1042,4.716651216,96.47547842
JOHAN PAHLAWAN,50,1258,522,251,2031,23,35,137,195,2226,4.189235873,96.11942677
SAMATIGA,60,448,225,155,828,11,12,53,76,904,4.251144843,96.05493233
BUBON,61,523,262,157,942,5,17,53,75,1017,4.303369568,96.12413904
ARONGAN LAMBALEK,62,850,371,254,1475,16,41,100,157,1632,4.335963853,95.94980489
WOYLA,70,989,469,338,1796,37,39,139,215,2011,4.378323673,96.08848296
WOYLA BARAT,71,566,279,194,1039,37,29,88,154,1193,4.414410889,95.9848155
WOYLA TIMUR,72,367,212,110,689,22,35,65,122,811,4.459648409,96.09188814
KAWAY XVI,80,1302,600,372,2274,50,51,169,270,2544,4.27082412,96.21768549
MEUREUBO,81,1297,538,306,2141,23,56,186,265,2406,4.165596247,96.21149216
PANTAI CEUREMEN,82,793,352,261,1406,17,30,104,151,1557,4.488155384,96.31873138
PANTON REU,83,601,248,157,1006,37,20,69,126,1132,4.437966365,96.20356842
SUNGAI MAS,90,199,75,54,328,6,22,44,72,400,4.621977163,96.21579292
LHOONG,10,386,185,134,705,4,11,68,83,788,5.256594121,95.28787177
LHONGA,20,333,172,84,589,91,16,46,153,742,5.470664038,95.26482825
LEUPUNG,21,125,57,43,225,8,1,16,25,250,5.344922822,95.30967846
INDRAPURI,30,1398,699,508,2605,44,32,157,233,2838,5.419373509,95.45420125
KUTA COT GLIE,31,1191,519,434,2144,66,68,182,316,2460,5.316345303,95.48007478
SEULIMEUM,40,1417,632,384,2433,135,121,314,570,3003,5.478853291,95.62482494
KOTA JANTHO,41,160,73,67,300,19,8,40,67,367,5.186029065,95.68679144
LEMBAH SEULAWAH,42,643,244,157,1044,26,35,118,179,1223,5.370043117,95.70774761
MESJID RAYA,50,916,409,251,1576,27,39,141,207,1783,5.586339928,95.51832327
DARUSSALAM,60,758,319,217,1294,17,30,115,162,1456,5.595138399,95.42050149
BAITUSSALAM,61,290,116,84,490,9,9,24,42,532,5.603294832,95.38196759
KUTA BARO,70,1057,538,410,2005,48,62,183,293,2298,5.552130862,95.42711187
MONTASIK,80,909,440,289,1638,37,57,170,264,1902,5.489621469,95.45946106
BLANG BINTANG,81,647,282,143,1072,21,38,97,156,1228,5.519195808,95.44599022
INGIN JAYA,90,1000,439,269,1708,57,57,137,251,1959,5.509331416,95.37046416
KRUENG BARONA JAYA,91,526,235,181,942,7,14,80,101,1043,5.548790866,95.3639169
SUKA MAKMUR,100,700,285,208,1193,15,27,129,171,1364,5.428901949,95.36566791
KUTA MALAKA,101,413,182,174,769,11,8,61,80,849,5.42734766,95.39387955
SIMPANG TIGA,102,380,169,120,669,6,10,56,72,741,5.446386338,95.34333934
DARUL IMARAH,110,1129,494,316,1939,35,34,156,225,2164,5.50747395,95.31359262
DARUL KAMAL,111,440,233,157,830,43,30,88,161,991,5.468507512,95.32325821
PEUKAN BADA,120,243,135,90,468,10,6,25,41,509,5.54075112,95.24167792
PULO ACEH,130,320,136,84,540,3,14,59,76,616,5.67366081,95.09792152
GEUMPANG,10,585,238,143,966,12,12,80,104,1070,4.845697547,96.27054138
MANE,11,722,277,145,1144,14,37,122,173,1317,4.885630406,96.09875399
GLUMPANG TIGA,70,1351,654,518,2523,14,36,170,220,2743,5.212602038,96.02669547
GLUMPANG BARO,71,985,466,289,1740,4,14,149,167,1907,5.28002866,96.03052016
MUTIARA,80,1269,600,435,2304,27,34,185,246,2550,5.287180321,95.97413505
MUTIARA TIMUR,81,2593,1191,810,4594,21,97,396,514,5108,5.256126266,95.98771293
TIRO/TRUSEB,90,789,373,248,1410,16,38,138,192,1602,5.144222642,95.98553585
TANGSE,100,2028,836,574,3438,39,94,336,469,3907,5.025420307,95.92403656
KEUMALA,111,878,375,275,1528,7,36,118,161,1689,5.22352771,95.86493973
TITEUE,112,479,234,138,851,12,19,91,122,973,5.205956674,95.91036967
SAKTI,120,1394,723,470,2587,21,39,191,251,2838,5.251746095,95.92911988
MILA,130,740,350,264,1354,20,18,129,167,1521,5.284871461,95.88578463
PADANG TIJI,140,2175,970,568,3713,19,90,301,410,4123,5.353583476,95.81737037
DELIMA,150,1863,848,549,3260,20,62,297,379,3639,5.336863081,95.899654
GRONG GRONG,151,571,232,153,956,8,17,105,130,1086,5.373778896,95.90209769
INDRAJAYA,160,1843,864,603,3310,21,43,223,287,3597,5.312160628,95.93567741
PEUKAN BARO,170,1216,541,407,2164,3,14,107,124,2288,5.32091699,95.96287471
KEMBANG TANJONG,180,1551,683,474,2708,13,35,170,218,2926,5.311830004,96.03010164
SIMPANG TIGA,190,1746,766,494,3006,7,31,228,266,3272,5.342143934,95.99216714
KOTA SIGLI,200,859,343,216,1418,6,21,116,143,1561,5.383238081,95.9581556
PIDIE,210,2812,1210,751,4773,66,112,424,602,5375,5.374554832,95.93628031
BATEE,220,2024,899,470,3393,41,190,490,721,4114,5.427821934,95.8865005
MUARA TIGA,230,1620,720,432,2772,29,101,337,467,3239,5.501178174,95.802372
SAMALANGA,10,1321,515,351,2187,28,36,152,216,2403,5.083702277,96.36567465
SIMPANG MAMPLAM,11,1999,744,465,3208,38,105,320,463,3671,5.106969755,96.41245863
PANDRAH,20,688,268,183,1139,14,23,91,128,1267,5.081626476,96.44515658
JEUNIEB,30,1711,647,374,2732,75,110,351,536,3268,5.074754122,96.47976687
PEULIMBANG,31,822,279,199,1300,37,57,152,246,1546,5.044092157,96.50586192
PEUDADA,40,1958,703,365,3026,45,85,345,475,3501,5.062546053,96.56775875
JULI,50,2524,939,612,4075,66,141,375,582,4657,5.054765534,96.68105368
JEUMPA,60,2458,989,501,3948,24,147,493,664,4612,5.149141868,96.65536377
KOTA JUANG,61,1662,643,379,2684,20,52,194,266,2950,5.197071296,96.714692
KUALA,62,1111,425,249,1785,34,76,215,325,2110,5.23055854,96.71784442
JANGKA,70,2185,968,671,3824,68,75,351,494,4318,5.250522329,96.79838577
PEUSANGAN,80,2406,1034,630,4070,99,67,295,461,4531,5.200320298,96.76906949
PEUSANGAN SELATAN,81,1115,401,265,1781,26,55,188,269,2050,5.062446398,96.76416351
PEUSANGAN SIBLAH KRUENG,82,1043,400,325,1768,23,29,129,181,1949,5.070709151,96.80294736
MAKMUR,90,1490,639,473,2602,39,49,156,244,2846,5.14245819,96.85390578
GANDA PURA,100,1684,741,535,2960,18,28,164,210,3170,5.227087874,96.87939103
KUTA BLANG,101,1392,637,457,2486,40,63,201,304,2790,5.208203354,96.83422996
SAWANG,10,3252,1402,1002,5656,87,167,530,784,6440,5.047635396,96.88548377
NISAM,20,1449,656,478,2583,35,78,191,304,2887,5.16780183,97.00950851
NISAM ANTARA,21,818,415,264,1497,70,23,74,167,1664,5.030758932,96.96042861
BANDA BARO,22,596,272,181,1049,79,40,132,251,1300,5.186947713,96.96889877
KUTA MAKMUR,30,1764,786,485,3035,41,64,262,367,3402,5.088883565,97.0479321
SIMPANG KERAMAT,31,498,215,117,830,2,23,81,106,936,5.042294493,97.07879066
SYAMTALIRA BAYU,40,1017,467,254,1738,38,57,147,242,1980,5.081541503,97.181194
GEUREUDONG PASE,41,224,123,75,422,5,5,24,34,456,4.953787391,97.02055791
MEURAH MULIA,50,1519,720,439,2678,29,56,225,310,2988,5.057730929,97.2025029
MATANGKULI,60,1145,524,308,1977,28,43,144,215,2192,5.029763274,97.27500812
PAYA BAKONG,61,1109,419,269,1797,30,61,139,230,2027,4.92357954,97.23835007
PIRAK TIMU,62,458,179,118,755,19,35,74,128,883,4.991858126,97.2860922
COT GIREK,70,861,399,159,1419,3,36,172,211,1630,4.872024549,97.34088061
TANAH JAMBO AYE,80,2673,1259,721,4653,114,139,444,697,5350,5.091336536,97.46578758
LANGKAHAN,81,1611,621,317,2549,72,161,349,582,3131,4.883396014,97.43939988
SEUNUDON,90,1602,803,499,2904,79,59,237,375,3279,5.195586451,97.4253806
BAKTIYA,100,2093,929,588,3610,70,111,360,541,4151,5.085682767,97.41648166
BAKTIYA BARAT,101,1528,722,383,2633,26,80,281,387,3020,5.132438187,97.34309034
LHOKSUKON,110,2598,1122,653,4373,80,183,531,794,5167,5.029923564,97.35935594
TANAH LUAS,120,1519,688,424,2631,29,49,203,281,2912,4.967279092,97.13761778
NIBONG,121,722,317,181,1220,29,58,157,244,1464,5.044575636,97.22556548
SAMUDERA,130,1379,729,426,2534,35,33,171,239,2773,5.122299754,97.22678731
SYAMTALIRA ARON,140,817,427,225,1469,15,22,81,118,1587,5.10421737,97.25627807
TANAH PASIR,150,525,250,189,964,23,19,51,93,1057,5.133408117,97.26540465
LAPANG,151,611,319,209,1139,7,7,59,73,1212,5.144302761,97.29325778
MUARA BATU,160,1283,645,435,2363,28,41,150,219,2582,5.241128009,96.94718647
DEWANTARA,170,1615,781,411,2807,29,51,222,302,3109,5.236660567,97.00837765
MANGGENG,10,826,392,229,1447,19,46,144,209,1656,3.621600791,96.92062122
LEMBAH SABIL,11,585,271,194,1050,11,22,102,135,1185,3.624844525,96.99374561
TANGAN-TANGAN,20,1000,463,332,1795,26,59,176,261,2056,3.688483882,96.98844701
SETIA,21,462,195,114,771,10,33,86,129,900,3.697915176,96.87478506
BLANG PIDIE,30,607,233,168,1008,6,23,87,116,1124,3.831100053,96.97984834
JEUMPA,31,909,387,265,1561,18,37,120,175,1736,3.764755229,96.80958938
SUSOH,40,907,417,256,1580,19,47,129,195,1775,3.727471969,96.81808069
KUALA BATEE,50,1016,464,288,1768,13,46,192,251,2019,3.872901165,96.78475464
BABAH ROT,60,1418,668,429,2515,44,77,241,362,2877,3.89545625,96.6882968
KUTA PANJANG,10,430,166,138,734,16,14,33,63,797,3.857372206,97.21924038
BLANG JERANGO,11,446,193,138,777,32,19,71,122,899,3.965993946,97.16605781
BLANGKEJEREN,20,1130,438,316,1884,33,48,163,244,2128,3.931862974,97.36822182
PUTRI BETUNG,21,877,327,186,1390,32,32,92,156,1546,3.781612977,97.46940797
DABUN GELANG,22,473,174,77,724,11,22,62,95,819,3.962728488,97.49194135
BLANG PEGAYON,23,442,180,112,734,4,9,43,56,790,3.831192784,97.28030795
PINING,30,524,214,142,880,22,22,83,127,1007,4.002145252,97.67410039
RIKIT GAIB,40,272,116,114,502,8,5,30,43,545,4.119170876,97.29752023
PANTAN CUACA,41,348,135,115,598,11,10,50,71,669,4.16374998,97.18252993
TERANGUN,50,662,340,191,1193,54,51,116,221,1414,4.049044494,96.91686873
TRIPE JAYA,51,399,196,98,693,15,12,50,77,770,4.16969406,96.9797272
TAMIANG HULU,10,417,165,78,660,10,32,67,109,769,4.157809997,97.84771952
BANDAR PUSAKA,11,778,341,132,1251,13,52,168,233,1484,4.273535567,97.85122839
KEJURUAN MUDA,20,1346,562,316,2224,28,79,257,364,2588,4.200627408,98.02182662
TENGGULUN,21,913,344,135,1392,24,93,231,348,1740,4.021171468,97.94042977
RANTAU,30,1292,597,318,2207,14,41,201,256,2463,4.298777712,98.10794495
KOTA KUALA SIMPANG,40,950,394,173,1517,13,38,172,223,1740,4.285110851,98.0616234
SEURUWAY,50,1474,601,352,2427,34,107,286,427,2854,4.342039029,98.20927428
BENDAHARA,60,979,506,265,1750,1,32,162,195,1945,4.412181113,98.18327519
BANDA MULIA,61,749,318,259,1326,8,14,78,100,1426,4.444484341,98.14222521
KARANG BARU,70,2199,928,451,3578,29,109,355,493,4071,4.343198638,98.04212979
SEKERAK,71,432,192,126,750,5,24,70,99,849,4.317124927,97.92465659
MANYAK PAYED,80,2599,1041,555,4195,52,153,509,714,4909,4.431318257,98.02639163
DARUL MAKMUR,10,3340,1459,930,5729,169,192,559,920,6649,3.966272908,96.5487803
KUALA,20,685,280,184,1149,19,25,102,146,1295,4.096412666,96.29782723
KUALA PESISIR,21,433,208,163,804,57,34,66,157,961,4.061415623,96.25754493
TADU RAYA,22,644,254,147,1045,38,36,95,169,1214,4.069616084,96.39255708
BEUTONG,30,1018,544,381,1943,140,47,138,325,2268,4.320183891,96.56843917
SEUNAGAN,40,728,325,252,1305,17,16,57,90,1395,4.229000914,96.30211507
SUKA MAKMUE,41,442,211,134,787,14,18,58,90,877,4.181121298,96.31753539
SEUNAGAN TIMUR,50,642,257,182,1081,26,15,76,117,1198,4.339826851,96.37137724
TEUNOM,10,325,194,144,663,17,6,63,86,749,4.560251579,95.91623625
PASIE RAYA,11,358,163,67,588,10,19,47,76,664,,
PANGA,20,346,176,110,632,16,15,63,94,726,4.641281731,95.80981851
KRUENG SABEE,30,250,124,107,481,6,15,40,61,542,4.78485012,95.79027232
SETIA BAKTI,40,157,108,58,323,10,10,34,54,377,4.804480482,95.64182716
SAMPOINIET,50,247,149,113,509,17,20,51,88,597,4.931873285,95.56336071
DARUL HIKMAH,51,395,189,132,716,15,18,79,112,828,,
JAYA,60,637,307,195,1139,8,38,155,201,1340,5.114956931,95.45777989
INDRA JAYA,61,135,73,57,265,3,10,36,49,314,,
TIMANG GAJAH,10,1195,542,310,2047,25,46,169,240,2287,4.794468145,96.77477435
GAJAH PUTIH,11,635,293,186,1114,23,27,100,150,1264,,
PINTU RIME GAYO,20,816,305,203,1324,24,46,129,199,1523,4.897721811,96.75138586
BUKIT,30,1221,473,336,2030,41,42,110,193,2223,4.716635156,96.87301943
WIH PESAM,40,835,308,161,1304,14,20,124,158,1462,4.725845447,96.80164245
BANDAR,50,1280,524,318,2122,58,39,126,223,2345,4.71913955,96.94324773
BENER KELIPAH,51,372,109,84,565,5,3,33,41,606,,
SYIAH UTAMA,60,175,54,26,255,4,10,39,53,308,4.740507155,97.13735806
MEUSIDAH,61,343,103,42,488,9,23,61,93,581,,
PERMATA,70,1222,434,245,1901,33,47,180,260,2161,4.824392624,96.92837344
MEUREUDU,10,1117,516,357,1990,23,32,141,196,2186,5.058466563,96.24074979
MEURAH DUA,20,722,338,191,1251,13,17,81,111,1362,5.220732734,96.2604096
BANDAR DUA,30,1790,834,499,3123,42,65,320,427,3550,5.112035318,96.31196926
JANGKA BUYA,40,551,220,131,902,15,23,62,100,1002,5.220238304,96.3248183
ULIM,50,947,421,254,1622,12,29,148,189,1811,5.189033872,96.26873273
TRIENGGADENG,60,1499,721,506,2726,15,26,163,204,2930,5.219353156,96.17169581
PANTERAJA,70,683,274,175,1132,4,11,91,106,1238,5.257310754,96.14604481
BANDAR BARU,80,2621,1270,975,4866,22,62,363,447,5313,5.183659276,96.09111397
MEURAXA,10,290,115,69,474,5,7,53,65,539,5.555536868,95.29626016
JAYA BARU,11,362,142,127,631,4,9,55,68,699,5.536250827,95.29699071
BANDA RAYA,12,319,145,109,573,9,5,39,53,626,5.527149891,95.31439949
BAITURRAHMAN,20,509,243,162,914,4,14,71,89,1003,5.544825917,95.31910588
LUENG BATA,21,478,245,155,878,6,6,58,70,948,5.539044739,95.33479193
KUTA ALAM,30,624,255,164,1043,10,11,72,93,1136,5.570625175,95.32975316
KUTA RAJA,31,233,101,54,388,3,2,40,45,433,5.569223747,95.31381753
SYIAH KUALA,40,307,153,115,575,3,8,59,70,645,5.583553144,95.35071039
ULEE KARENG,41,546,235,181,962,9,13,78,100,1062,5.548537144,95.34828647
SUKAJAYA,10,636,262,152,1050,7,15,111,133,1183,5.8236229,95.32553591
SUKAKARYA,20,719,309,195,1223,9,23,119,151,1374,5.85878241,95.27776985
LANGSA TIMUR,10,764,325,191,1280,14,53,171,238,1518,4.464919712,98.02207227
LANGSA LAMA,11,956,426,260,1642,17,44,197,258,1900,4.450372666,97.96222826
LANGSA BARAT,20,1252,508,279,2039,24,108,268,400,2439,4.510078034,97.99714905
LANGSA BARO,21,1125,516,283,1924,19,48,255,322,2246,4.490292208,97.92380774
LANGSA KOTA,30,822,383,242,1447,11,38,161,210,1657,4.471145439,97.97416318
BLANG MANGAT,10,1322,544,414,2280,17,41,204,262,2542,5.123495133,97.13476165
MUARA DUA,20,1475,636,434,2545,38,54,238,330,2875,5.161029942,97.1272009
MUARA SATU,21,1686,733,521,2940,15,41,199,255,3195,5.201913873,97.07211747
BANDA SAKTI,30,2371,1011,688,4070,43,98,334,475,4545,5.191292462,97.13511088
SIMPANG KIRI,10,1691,697,402,2790,32,57,187,276,3066,2.674185103,97.9728187
PENANGGALAN,20,657,283,149,1089,12,26,73,111,1200,2.691067894,98.06119533
RUNDENG,30,1484,590,351,2425,59,41,103,203,2628,2.68783991,97.84826438
SULTAN DAULAT,40,1690,740,429,2859,50,51,160,261,3120,2.829490818,97.93354885
LONGKIB,50,323,119,69,511,8,11,38,57,568,2.576190527,97.87829818
IDANO GAWO,60,2737,746,310,3793,145,175,298,618,4411,1.044165148,97.78883319
BAWOLATO,61,3059,844,357,4260,157,219,299,675,4935,0.970399581,97.86530707
ULUGAWO,62,1337,434,273,2044,72,57,113,242,2286,0.982224359,97.72159695
GIDO,70,3661,1046,461,5168,131,214,392,737,5905,1.11417081,97.72551594
MA U,81,836,169,87,1092,100,172,172,444,1536,1.050943604,97.63722252
SOMOLO - MOLO,82,710,228,148,1086,73,61,60,194,1280,1.0359832,97.67076113
HILIDUHO,130,953,234,77,1264,17,51,125,193,1457,1.241164994,97.52870069
HILI SERANGKAI,131,530,166,70,766,28,33,48,109,875,1.173254342,97.59418489
BOTOMUZOI,132,1058,293,187,1538,36,49,96,181,1719,1.169968079,97.54152026
BATAHAN,10,1488,626,386,2500,56,98,273,427,2927,0.379205402,99.22684534
SINUNUKAN,11,603,230,112,945,10,38,100,148,1093,0.471061565,99.24219134
BATANG NATAL,20,1764,758,493,3015,18,76,234,328,3343,0.665008561,99.43252232
LINGGA BAYU,21,1742,658,338,2738,17,79,300,396,3134,0.599819022,99.27092702
RANTO BAEK,22,971,329,131,1431,32,69,140,241,1672,0.519823053,99.37725896
KOTANOPAN,30,1731,722,479,2932,46,94,260,400,3332,0.630624107,99.72502341
ULU PUNGKUT,31,403,195,134,732,18,20,60,98,830,0.530466749,99.76778293
TAMBANGAN,32,775,314,187,1276,24,56,113,193,1469,0.68905211,99.64663279
LEMBAH SORIK MARAPI,33,488,202,111,801,13,18,47,78,879,0.741629439,99.59997054
PUNCAK SORIK MARAPI,34,660,288,165,1113,10,29,92,131,1244,0.682541057,99.57598565
MUARA SIPONGI,40,1041,417,249,1707,24,59,137,220,1927,0.613458478,99.88113462
PAKANTAN,41,253,128,38,419,3,15,42,60,479,0.526692397,99.89945105
PANYABUNGAN,50,4983,1669,1116,7768,113,352,787,1252,9020,0.866112246,99.61472801
PANYABUNGAN SELATAN,51,614,253,169,1036,13,31,93,137,1173,0.754308322,99.53747906
PANYABUNGAN BARAT,52,837,236,119,1192,24,82,162,268,1460,0.819242447,99.49707713
PANYABUNGAN UTARA,53,1509,603,285,2397,30,71,221,322,2719,0.931162226,99.55239322
PANYABUNGAN TIMUR,54,1582,506,276,2364,75,167,306,548,2912,0.791971684,99.73854448
HUTA BARGOT,55,372,132,70,574,17,28,106,151,725,0.877623611,99.45106657
NATAL,60,878,343,170,1391,42,58,184,284,1675,0.715897866,99.18403626
MUARA BATANG GADIS,70,1591,581,331,2503,88,152,292,532,3035,1.02764149,99.0976206
SIABU,80,3588,1623,968,6179,72,172,465,709,6888,1.029031704,99.4669058
BUKIT MALINTANG,81,791,338,181,1310,11,31,117,159,1469,0.975074894,99.54464015
NAGA JUANG,82,321,127,89,537,13,18,46,77,614,0.929402998,99.45414721
BATANG ANGKOLA,10,2379,1108,624,4111,46,73,361,480,4591,1.228407304,99.24002689
SAYUR MATINGGI,11,1902,733,347,2982,58,107,288,453,3435,1.111146539,99.33530902
TANO TOMBANGAN ANGKOLA,12,1288,562,408,2258,10,41,107,158,2416,,
ANGKOLA TIMUR,70,1418,581,326,2325,17,65,190,272,2597,1.463489525,99.33444771
ANGKOLA SELATAN,80,2367,777,284,3428,232,341,600,1173,4601,1.318165972,99.14958392
ANGKOLA  BARAT,90,1590,662,404,2656,32,107,304,443,3099,1.393650084,99.08391312
ANGKOLA SANGKUNUR,91,1384,431,108,1923,113,164,317,594,2517,,
BATANG TORU,100,1328,530,292,2150,36,84,224,344,2494,1.549880633,99.08519657
MARANCAR,101,830,353,186,1369,9,34,109,152,1521,1.51179869,99.17288763
MUARA BATANG TORU,102,976,313,123,1412,28,139,223,390,1802,1.387514182,98.89942697
SIPIROK,110,2114,920,464,3498,29,126,384,539,4037,1.603423923,99.29954964
ARSE,120,513,195,135,843,4,20,111,135,978,1.702683381,99.35092575
SAIPAR DOLOK HOLE,160,1257,452,166,1875,29,64,244,337,2212,1.815309872,99.43743805
AEK BILAH,161,472,60,6,538,7,87,106,200,738,1.988593338,99.49466964
PINANG SORI,10,1306,396,183,1885,72,131,209,412,2297,1.536399319,98.86898062
BADIRI,11,1463,469,212,2144,185,204,326,715,2859,1.573505923,98.83227608
SIBABANGUN,20,884,280,119,1283,87,125,182,394,1677,1.583009583,98.99786453
LUMUT,21,1001,203,75,1279,159,202,254,615,1894,1.523696893,98.90330549
SUKABANGUN,22,310,100,42,452,27,42,47,116,568,1.457411102,98.93430704
PANDAN,30,1412,419,168,1999,84,131,185,400,2399,1.686932026,98.83943209
TUKKA,31,480,152,74,706,33,48,57,138,844,1.702846864,98.91830488
SARUDIK,32,725,207,103,1035,35,36,75,146,1181,1.737475219,98.84102195
TAPIAN NAULI,40,1090,409,192,1691,45,71,149,265,1956,1.724940901,98.63941511
SITAHUIS,41,494,194,119,807,12,17,64,93,900,1.805132084,98.82388585
KOLANG,50,1222,484,301,2007,54,81,167,302,2309,1.864806528,98.71273599
SORKAM,60,1083,444,242,1769,27,61,118,206,1975,1.924516255,98.66635745
SORKAM BARAT,61,1353,526,279,2158,26,63,217,306,2464,1.919706439,98.56362989
PASARIBU TOBING,62,417,167,88,672,17,26,42,85,757,1.985689861,98.61877209
BARUS,70,1184,485,285,1954,48,73,191,312,2266,2.02462483,98.41136335
SOSOR GADONG,71,699,247,174,1120,25,23,65,113,1233,2.020791811,98.51764533
ANDAM DEWI,72,1340,482,270,2092,37,71,156,264,2356,2.068088558,98.39434094
BARUS UTARA,73,272,98,65,435,9,15,18,42,477,2.060595191,98.4328784
MANDUAMAS,80,1506,640,372,2518,118,108,217,443,2961,2.181264562,98.22229911
SIRANDORUNG,81,1052,446,276,1774,148,61,135,344,2118,2.10209054,98.32253297
PARMONANGAN,30,1097,410,183,1690,20,18,135,173,1863,2.058640194,98.78994996
ADIAN KOTING,40,1309,601,359,2269,28,33,185,246,2515,1.881066452,98.91271534
SIPOHOLON,50,1446,623,375,2444,16,24,131,171,2615,2.063642906,98.9212223
TARUTUNG,60,1763,792,478,3033,27,45,208,280,3313,2.023677102,98.98648137
SIATAS BARITA,61,815,326,181,1322,13,15,64,92,1414,2.004827672,99.04862017
PAHAE JULU,70,1030,457,339,1826,16,21,102,139,1965,1.879908882,99.0588377
PAHAE JAE,80,760,360,243,1363,9,6,50,65,1428,1.820360347,99.15029398
PURBATUA,81,624,258,119,1001,10,18,48,76,1077,1.722772425,99.06669142
SIMANGUMBAN,82,816,381,206,1403,14,21,60,95,1498,1.760120027,99.22707322
PANGARIBUAN,90,1726,680,421,2827,29,30,127,186,3013,1.95805757,99.20221429
GAROGA,100,1396,447,206,2049,49,37,96,182,2231,2.030126101,99.35149626
SIPAHUTAR,110,1903,707,405,3015,23,36,114,173,3188,2.12952411,99.13488371
SIBORONG-BORONG,120,2572,1039,633,4244,34,43,191,268,4512,2.20690437,99.02544166
PAGARAN,130,1132,470,301,1903,14,19,82,115,2018,2.177694975,98.88425527
MUARA,180,1001,458,277,1736,12,7,69,88,1824,2.320499854,98.94807448
BALIGE,30,1653,602,386,2641,21,20,150,191,2832,2.30053671,99.08127905
TAMPAHAN,31,292,118,57,467,0,0,14,14,481,2.310156245,99.01379028
LAGU BOTI,40,1039,408,255,1702,9,10,64,83,1785,2.329999715,99.16220096
HABINSARAN,50,1053,320,151,1524,21,13,70,104,1628,2.360440882,99.34292638
BORBOR,51,399,110,79,588,6,10,24,40,628,2.208977933,99.28320207
NASSAU,52,686,247,111,1044,19,27,60,106,1150,2.313263171,99.4696541
SILAEN,60,828,272,146,1246,15,20,45,80,1326,2.429459606,99.27579075
SIGUMPAR,61,514,184,98,796,2,4,25,31,827,2.394055454,99.17918859
PORSEA,70,432,153,95,680,2,3,35,40,720,2.47587223,99.12559332
PINTU POHAN MERANTI,71,351,113,65,529,7,12,32,51,580,2.529662397,99.35175098
SIANTAR NARUMONDA,72,365,154,90,609,2,3,29,34,643,2.454441247,99.21641996
PARMAKSIAN,73,229,98,54,381,1,6,18,25,406,2.487059206,99.19195039
LUMBAN JULU,80,559,211,117,887,10,9,39,58,945,2.568870809,99.03470109
ULUAN,81,685,234,136,1055,8,8,57,73,1128,2.44151773,99.08041172
AJIBATA,82,454,142,70,666,1,5,28,34,700,2.607748493,98.94708282
BONATUA LUNASI,83,383,171,86,640,8,4,22,34,674,2.528248313,99.12496557
BILAH HULU,50,1136,390,183,1709,65,100,248,413,2122,1.986789414,99.93018016
PANGKATAN,70,1153,462,211,1826,22,79,244,345,2171,2.186229999,100.0169267
BILAH BARAT,80,1413,472,226,2111,50,136,304,490,2601,2.088591036,99.79768708
BILAH HILIR,130,2378,1016,529,3923,67,184,592,843,4766,2.342679217,100.0750076
PANAI HULU,140,1618,639,386,2643,113,170,357,640,3283,2.425791619,100.1384694
PANAI TENGAH,150,2330,794,375,3499,170,290,664,1124,4623,2.365796516,100.2428297
PANAI HILIR,160,2869,1014,493,4376,149,295,655,1099,5475,2.617154173,100.1732774
RANTAU SELATAN,210,1206,522,308,2036,78,83,245,406,2442,2.061438352,99.84610854
RANTAU UTARA,220,1967,849,496,3312,69,66,303,438,3750,2.104980312,99.82349814
BANDAR PASIR MANDOGE,10,973,379,185,1537,64,86,176,326,1863,2.735139692,99.26252886
BANDAR PULAU,20,1154,448,247,1849,40,87,223,350,2199,2.663871269,99.40003441
AEK SONGSONGAN,21,783,366,173,1322,26,35,145,206,1528,2.605117428,99.36952596
RAHUNING,22,572,227,83,882,23,70,146,239,1121,2.729807541,99.50921408
PULAU RAKYAT,30,1493,475,177,2145,77,193,345,615,2760,2.733022242,99.68280653
AEK KUASAN,31,724,283,109,1116,31,84,199,314,1430,2.667194039,99.71028512
AEK LEDONG,32,438,155,64,657,18,55,101,174,831,2.611060829,99.64753278
SEI KEPAYANG,40,1812,705,302,2819,44,129,397,570,3389,2.832898689,99.8647601
SEI KEPAYANG BARAT,41,1345,531,286,2162,75,106,210,391,2553,2.957833883,99.85247582
SEI KEPAYANG TIMUR,42,992,337,132,1461,53,126,300,479,1940,2.959005314,99.92247437
TANJUNG BALAI,50,3699,1227,548,5474,282,529,952,1763,7237,3.035561195,99.81755732
SIMPANG EMPAT,60,1963,705,305,2973,116,248,420,784,3757,2.901055281,99.74599557
TELUK DALAM,61,780,247,122,1149,26,55,142,223,1372,2.809768295,99.66873381
AIR BATU,70,1369,568,217,2154,48,108,263,419,2573,2.863547823,99.6250195
SEI DADAP,71,1296,489,187,1972,34,153,358,545,2517,2.941387032,99.64634085
BUNTU PANE,80,364,177,169,710,22,9,19,50,760,2.861580062,99.4878162
TINGGI RAJA,81,630,289,126,1045,7,21,158,186,1231,2.832369131,99.53998747
SETIA JANJI,82,441,175,90,706,11,32,121,164,870,2.937196316,99.48911521
MERANTI,90,996,445,224,1665,8,43,159,210,1875,3.083070353,99.61911547
PULO BANDRING,91,966,402,185,1553,29,52,218,299,1852,2.992836738,99.55617753
RAWANG PANCA ARGA,92,758,342,197,1297,52,44,161,257,1554,3.060046577,99.66131499
AIR JOMAN,100,2702,971,397,4070,123,345,782,1250,5320,3.012230393,99.71566234
SILAU LAUT,101,1665,632,219,2516,72,168,462,702,3218,3.089554673,99.74507311
KISARAN BARAT,160,1491,602,255,2348,39,103,293,435,2783,2.994486464,99.59691042
KISARAN TIMUR,170,2209,868,410,3487,41,121,353,515,4002,2.986001305,99.64470652
SILIMAKUTA,10,727,244,127,1098,16,25,73,114,1212,2.955182975,98.63082219
PEMATANG SILIMAHUTA,11,804,297,154,1255,22,35,110,167,1422,2.945415976,98.57144052
PURBA,20,1457,532,298,2287,28,26,89,143,2430,2.9146513,98.71378544
HARANGGAOL HORISON,21,347,133,72,552,0,12,42,54,606,2.866466193,98.66833644
DOLOK PARDAMEAN,30,853,374,212,1439,17,17,81,115,1554,2.843017918,98.81553188
SIDAMANIK,40,991,438,303,1732,68,20,64,152,1884,2.842865122,98.94201333
PEMATANG SIDAMANIK,41,696,302,198,1196,29,18,66,113,1309,2.785287878,98.87934701
GIRSANG SIPANGAN BOLON,50,557,256,148,961,5,13,75,93,1054,2.675803231,98.96900422
TANAH JAWA,60,2149,961,541,3651,45,72,350,467,4118,2.879050117,99.17581519
HATONDUHAN,61,907,468,289,1664,82,44,158,284,1948,2.746991538,99.12468602
DOLOK PANRIBUAN,70,1567,745,494,2806,30,37,147,214,3020,2.778206603,99.03609526
JORLANG HATARAN,80,973,444,218,1635,34,29,143,206,1841,2.822857344,99.00389549
PANEI,90,1397,696,483,2576,23,24,111,158,2734,2.900508314,98.93933519
PANOMBEAN PANEI,91,1078,510,308,1896,78,27,128,233,2129,2.953963757,98.98770013
RAYA,100,1719,658,398,2775,47,50,134,231,3006,2.979387748,98.85596552
DOLOK SILAU,110,569,219,112,900,18,25,62,105,1005,3.068136704,98.70136553
SILAU KAHEAN,120,969,402,211,1582,48,45,157,250,1832,3.178582771,98.85268009
RAYA KAHEAN,130,837,404,259,1500,28,26,102,156,1656,3.11806298,98.92309375
TAPIAN DOLOK,140,1191,483,208,1882,19,63,230,312,2194,3.065403172,99.06539
DOLOK BATU NANGGAR,150,983,423,250,1656,52,56,162,270,1926,3.123766852,99.14946113
SIANTAR,160,1752,766,404,2922,40,71,264,375,3297,2.940237663,99.10610333
GUNUNG MALELA,161,746,347,206,1299,27,41,163,231,1530,3.023293566,99.20292617
GUNUNG MALIGAS,162,646,260,141,1047,29,37,162,228,1275,3.047501064,99.15397939
HUTABAYU RAJA,170,1093,462,221,1776,21,49,159,229,2005,2.988245959,99.29592626
JAWA MARAJA BAH JAMBI,171,628,252,140,1020,7,16,83,106,1126,2.960582178,99.2231861
PEMATANG BANDAR,180,910,405,287,1602,22,38,101,161,1763,3.103057793,99.24799431
BANDAR HULUAN,181,585,278,151,1014,28,39,143,210,1224,3.167700262,99.22040285
BANDAR,190,1687,827,476,2990,43,113,341,497,3487,3.184938326,99.32106389
BANDAR MASILAM,191,1014,436,185,1635,27,105,278,410,2045,3.253277674,99.29743076
BOSAR MALIGAS,200,1018,461,350,1829,81,63,105,249,2078,3.048336231,99.37464119
UJUNG PADANG,210,1548,792,617,2957,52,72,223,347,3304,3.018176016,99.46200462
SIDIKALANG,30,2349,1018,613,3980,53,59,275,387,4367,2.740239324,98.31997237
BERAMPU,31,815,379,206,1400,9,17,86,112,1512,2.733980115,98.2540002
SITINJO,32,685,272,165,1122,38,30,77,145,1267,2.702855787,98.36190303
PARBULUAN,40,1714,692,305,2711,18,44,183,245,2956,2.634665693,98.47397594
SUMBUL,50,3316,1334,715,5365,52,66,240,358,5723,2.754968115,98.4489136
SILAHI SABUNGAN,51,378,202,141,721,4,11,42,57,778,2.770586769,98.52917315
SILIMA PUNGGA-PUNGGA,60,1024,473,281,1778,16,22,108,146,1924,2.858265338,98.05943432
LAE PARIRA,61,1170,455,295,1920,11,33,118,162,2082,2.787028065,98.18144592
SIEMPAT NEMPU,70,1767,792,426,2985,16,50,165,231,3216,2.813674497,98.22094515
SIEMPAT NEMPU HULU,80,1430,628,361,2419,29,38,148,215,2634,2.820487432,98.27248349
SIEMPAT NEMPU HILIR,90,1014,479,240,1733,18,29,126,173,1906,2.899258898,98.06554666
TIGA LINGGA,100,1428,549,235,2212,40,73,164,277,2489,2.890968369,98.24792012
GUNUNG SITEMBER,101,833,317,127,1277,11,41,122,174,1451,2.946877367,98.14668446
PEGAGAN HILIR,110,1418,508,265,2191,27,31,102,160,2351,2.854631178,98.38724031
TANAH PINEM,120,1105,270,87,1462,74,129,191,394,1856,2.997166805,98.10452924
MARDINGDING,10,1618,489,215,2322,49,71,213,333,2655,3.233308262,98.02924131
LAUBALENG,20,987,343,186,1516,32,35,109,176,1692,3.136227684,98.07391521
TIGA BINANGA,30,1063,363,159,1585,20,42,104,166,1751,3.095663761,98.21147726
JUHAR,40,800,256,119,1175,32,21,56,109,1284,2.999329746,98.29376561
MUNTE,50,1434,489,216,2139,17,37,131,185,2324,3.059869688,98.37724159
KUTA BULUH,60,454,135,65,654,34,24,59,117,771,3.199419173,98.22258268
PAYUNG,70,470,174,92,736,11,15,58,84,820,3.1260331,98.37535061
TIGANDERKET,71,766,265,132,1163,10,20,78,108,1271,3.189995117,98.3458933
SIMPANG EMPAT,80,974,350,140,1464,32,55,128,215,1679,3.137693389,98.45278666
NAMAN TERAN,81,783,227,78,1088,25,35,81,141,1229,3.201510768,98.41642807
MERDEKA,82,544,201,98,843,39,25,81,145,988,3.199803187,98.48023785
KABANJAHE,90,2069,722,303,3094,39,64,208,311,3405,3.103323838,98.47513809
BERASTAGI,100,2345,826,350,3521,16,88,289,393,3914,3.189769687,98.51683823
TIGAPANAH,110,1376,475,203,2054,31,54,187,272,2326,3.068794144,98.50299516
DOLAT RAYAT,111,403,144,61,608,11,19,39,69,677,3.172430866,98.54309196
MEREK,120,1088,342,114,1544,28,54,105,187,1731,2.956875312,98.48053454
BARUSJAHE,130,1243,451,197,1891,23,47,117,187,2078,3.136128369,98.58060068
GUNUNG MERIAH,10,148,63,35,246,3,5,23,31,277,3.128495883,98.66814733
SINEMBAH TANJUNG MUDA HULU,20,574,150,88,812,19,26,58,103,915,3.24510498,98.69846988
SIBOLANGIT,30,773,302,181,1256,26,26,95,147,1403,3.30355421,98.5653164
KUTALIMBARU,40,1851,708,326,2885,68,142,383,593,3478,3.416086137,98.52136067
PANCUR BATU,50,2806,1028,536,4370,127,163,435,725,5095,3.486790369,98.57941839
NAMO RAMBE,60,951,343,209,1503,31,55,161,247,1750,3.442117243,98.63827057
BIRU-BIRU,70,1344,467,213,2024,60,107,269,436,2460,3.385913297,98.65853968
SINEMBAH TANJUNG MUDA HILIR,80,1112,423,249,1784,35,53,175,263,2047,3.37400609,98.72157513
BANGUN PURBA,90,819,320,132,1271,15,28,153,196,1467,3.370971492,98.82046279
GALANG,190,1602,646,287,2535,60,125,373,558,3093,3.439243776,98.88515092
TANJUNG MORAWA,200,4983,2023,946,7952,116,277,934,1327,9279,3.531884467,98.8064877
PATUMBAK,210,2593,1002,452,4047,132,193,486,811,4858,3.494930145,98.72241606
DELI TUA,220,1119,472,269,1860,29,82,242,353,2213,3.495921903,98.6903119
SUNGGAL,230,3041,1286,632,4959,70,170,631,871,5830,3.614399411,98.57960642
HAMPARAN PERAK,240,4935,1790,677,7402,328,711,1643,2682,10084,3.766626004,98.60085604
LABUHAN DELI,250,1846,616,233,2695,63,195,456,714,3409,3.767494807,98.6574533
PERCUT SEI TUAN,260,6143,2554,1175,9872,200,468,1418,2086,11958,3.657778837,98.75099689
BATANG KUIS,270,1257,455,256,1968,35,130,317,482,2450,3.624857078,98.82145016
PANTAI LABU,280,2836,943,486,4265,133,316,657,1106,5371,3.667498528,98.87906184
BERINGIN,290,1688,648,291,2627,46,101,353,500,3127,3.623302684,98.87765106
LUBUK PAKAM,300,1935,887,504,3326,66,76,309,451,3777,3.569858084,98.88501633
PAGAR MERBAU,310,1357,544,200,2101,36,116,359,511,2612,3.543759051,98.89988153
BOHOROK,10,2265,869,364,3498,65,172,564,801,4299,3.465919779,98.09418175
SERAPIT,11,909,367,143,1419,45,86,221,352,1771,3.582537555,98.29986524
SALAPIAN,20,1267,495,261,2023,37,82,237,356,2379,3.430824476,98.31172387
KUTAMBARU,21,548,158,49,755,35,47,124,206,961,3.329317905,98.27621226
SEI BINGAI,30,2243,887,429,3559,168,213,451,832,4391,3.377677459,98.45563491
KUALA,40,1504,447,236,2187,79,134,314,527,2714,3.462464663,98.38314826
SELESAI,50,3444,1231,502,5177,181,480,995,1656,6833,3.613298517,98.40034019
BINJAI,60,1401,517,254,2172,35,115,372,522,2694,3.662627866,98.4592858
STABAT,70,3866,1529,727,6122,97,237,758,1092,7214,3.733465047,98.4615612
WAMPU,80,1366,538,298,2202,261,243,470,974,3176,3.700188924,98.33997462
BATANG SERANGAN,90,1316,361,117,1794,80,177,361,618,2412,3.693838155,98.03090026
SAWIT SEBERANG,100,848,370,145,1363,39,93,219,351,1714,3.821729459,98.22944204
PADANG TUALANG,110,2188,808,343,3339,72,248,614,934,4273,3.814289549,98.32323328
HINAI,120,3283,1048,397,4728,111,390,894,1395,6123,3.832990496,98.42847513
SECANGGANG,130,4499,1434,614,6547,157,459,1145,1761,8308,3.865560464,98.54107171
TANJUNG PURA,140,5214,1685,677,7576,216,647,1440,2303,9879,3.961486715,98.47596117
GEBANG,150,3224,1292,543,5059,74,271,863,1208,6267,3.973459603,98.37539496
BABALAN,160,4322,1676,994,6992,70,250,805,1125,8117,4.032654121,98.33563188
SEI LEPAN,170,3156,1022,464,4642,125,392,892,1409,6051,3.884033496,98.17544054
BRANDAN BARAT,180,1921,667,338,2926,149,240,546,935,3861,4.035328297,98.25560593
BESITANG,190,3502,1453,689,5644,103,248,828,1179,6823,3.954231107,98.06906751
PANGKALAN SUSU,200,2672,984,484,4140,103,241,590,934,5074,4.139746322,98.2209861
PEMATANG JAYA,201,956,355,141,1452,39,111,299,449,1901,4.209756783,98.15142033
HIBALA,10,745,271,143,1159,102,115,187,404,1563,-0.368376556,98.45459946
PULAU-PULAU BATU,20,534,184,101,819,38,68,146,252,1071,-0.104173833,98.29892284
PULAU-PULAU BATU TIMUR,21,36,5,2,43,5,11,12,28,71,0.09483187,98.65991694
TELUK DALAM,30,1312,510,417,2239,192,113,183,488,2727,0.609360653,97.83254805
FANAYAMA,31,1091,439,343,1873,36,51,184,271,2144,0.616314725,97.76851496
TOMA,32,931,413,263,1607,47,63,160,270,1877,0.669069258,97.87770348
MANIAMOLO,33,959,390,271,1620,99,61,109,269,1889,0.647768884,97.73235883
MAZINO,34,707,313,263,1283,64,43,110,217,1500,0.705624535,97.82813982
AMANDRAYA,40,1603,707,517,2827,390,216,360,966,3793,0.749976193,97.68764654
ARAMO,41,658,258,200,1116,273,133,159,565,1681,0.730079074,97.74410765
LAHUSA,50,4073,1703,1085,6861,510,452,787,1749,8610,0.797890324,97.84823566
GOMO,60,2326,889,530,3745,357,196,406,959,4704,0.879419962,97.78796778
SUSUA,61,1761,644,310,2715,525,389,508,1422,4137,0.79527806,97.76045935
MAZO,62,1030,370,252,1652,614,265,374,1253,2905,0.824594108,97.76909648
UMBUNASI,63,469,192,124,785,257,133,164,554,1339,0.923363705,97.74058136
LOLOMATUA,70,2992,1163,722,4877,370,301,597,1268,6145,0.921844068,97.66670684
LOLOWA'U,80,3429,1148,676,5253,861,777,1100,2738,7991,0.920150768,97.5953475
HILIMEGAI,81,407,153,109,669,186,111,117,414,1083,0.861053618,97.6343589
PAKKAT,10,2054,873,431,3358,22,34,131,187,3545,2.168223187,98.45703977
ONAN GANJANG,20,1048,411,257,1716,5,16,109,130,1846,2.119053849,98.62236835
SIJAMA POLANG,30,579,242,168,989,4,8,42,54,1043,2.143516038,98.70503546
DOLOK SANGGUL,40,2802,1001,491,4294,18,41,177,236,4530,2.250412117,98.73265239
LINTONG NIHUTA,50,1936,656,361,2953,16,22,78,116,3069,2.259552136,98.85610163
PARANGINAN,60,1123,331,160,1614,16,22,42,80,1694,2.295255066,98.92936046
BAKTI RAJA,70,606,262,187,1055,4,7,17,28,1083,2.329838933,98.81850438
POLLUNG,80,1584,671,370,2625,27,18,77,122,2747,2.354492603,98.6902428
PARLILITAN,90,1590,707,430,2727,21,13,117,151,2878,2.375553635,98.4678439
TARA BINTANG,100,893,365,175,1433,6,22,114,142,1575,2.264311236,98.37052319
SALAK,10,557,237,115,909,5,8,34,47,956,2.459273094,98.2853313
SITELLU TALI URANG JEHE,11,1060,394,203,1657,31,28,102,161,1818,2.661810247,98.16309443
PAGINDAR,12,155,75,22,252,4,9,39,52,304,2.43678948,98.17740124
SITELLU TALI URANG JULU,13,372,170,97,639,4,7,33,44,683,2.500296588,98.37878149
PERGETTENG-GETTENG SENGKUT,14,350,150,87,587,2,8,33,43,630,2.5429503,98.25169594
KERAJAAN,20,769,321,158,1248,16,25,90,131,1379,2.638488941,98.28490481
TINADA,21,386,160,96,642,5,16,35,56,698,2.601812094,98.31878088
SIEMPAT RUBE,22,424,179,100,703,12,12,36,60,763,2.57373467,98.40067874
SIANJUR MULA MULA,10,994,295,187,1476,12,9,53,74,1550,2.633911953,98.60682423
HARIAN,20,737,263,141,1141,8,7,42,57,1198,2.506307019,98.5915367
SITIO-TIO,30,815,291,141,1247,28,12,46,86,1333,2.448993185,98.76336212
ONAN RUNGGU,40,888,300,136,1324,11,19,42,72,1396,2.497827705,98.9450388
NAINGGOLAN,50,1027,385,212,1624,9,9,64,82,1706,2.474070514,98.89603257
PALIPI,60,1408,512,311,2231,12,7,88,107,2338,2.528028823,98.819019
RONGGUR NIHUTA,70,885,288,126,1299,8,12,35,55,1354,2.618501782,98.79374476
PANGURURAN,80,2243,875,486,3604,24,22,141,187,3791,2.628934545,98.71981518
SIMANINDO,90,1339,491,272,2102,22,12,109,143,2245,2.666395157,98.8059448
KOTARIH,10,209,82,19,310,9,16,53,78,388,3.288681526,98.85716713
SILINDA,11,329,113,61,503,11,26,44,81,584,3.262568177,98.79735202
BINTANG BAYU,12,435,107,58,600,11,18,59,88,688,3.296692112,98.92726037
DOLOK MASIHUL,20,1581,607,303,2491,57,106,319,482,2973,3.326617081,99.02061962
SERBAJADI,21,508,182,71,761,16,44,130,190,951,3.390424932,98.94141914
SIPISPIS,30,1049,454,191,1694,47,92,269,408,2102,3.16281786,99.0149038
DOLOK MERAWAN,40,404,117,46,567,23,26,74,123,690,3.190483983,99.11868185
TEBINGTINGGI,50,949,308,101,1358,49,108,230,387,1745,3.338235366,99.14796361
TEBING SYAHBANDAR,51,707,241,87,1035,20,71,182,273,1308,3.294825079,99.20481318
BANDAR KHALIPAH,60,1488,601,351,2440,42,95,294,431,2871,3.418058608,99.26744465
TANJUNG BERINGIN,70,2890,995,421,4306,130,311,631,1072,5378,3.482663575,99.21172233
SEI RAMPAH,80,2034,702,272,3008,65,184,482,731,3739,3.456685433,99.07233123
SEI BAMBAN,81,2178,874,444,3496,39,102,320,461,3957,3.425491891,99.15240828
TELUK MENGKUDU,90,2113,648,230,2991,79,256,482,817,3808,3.538028218,99.1242425
PERBAUNGAN,100,2930,1024,414,4368,144,268,683,1095,5463,3.55998643,98.99970326
PEGAJAHAN,101,693,227,82,1002,19,49,135,203,1205,3.48431742,98.97838751
PANTAI CERMIN,110,1783,544,228,2555,155,236,521,912,3467,3.616693899,98.98980138
SEI BALAI,10,1339,585,288,2212,26,88,287,401,2613,3.104417878,99.58027132
TANJUNG TIRAM,20,6410,2195,1065,9670,433,979,1811,3223,12893,3.168459368,99.65758079
TALAWI,30,2447,973,422,3842,224,307,787,1318,5160,3.167596161,99.53512044
LIMAPULUH,40,4600,1581,738,6919,186,577,1176,1939,8858,3.21888089,99.45861168
AIR PUTIH,50,1377,562,231,2170,45,112,301,458,2628,3.287346961,99.39597693
SEI SUKA,60,827,325,125,1277,30,103,245,378,1655,3.318877288,99.32801193
MEDANG DERAS,70,2515,792,392,3699,193,315,592,1100,4799,3.3787919,99.36290866
BATANG ONANG,10,851,311,197,1359,22,36,108,166,1525,1.330335163,99.46437867
PADANG BOLAK JULU,20,754,253,128,1135,18,60,111,189,1324,1.485200688,99.48072297
PORTIBI,30,1347,458,212,2017,40,73,137,250,2267,1.407748592,99.65512774
PADANG BOLAK,40,3521,1195,541,5257,47,209,614,870,6127,1.549103705,99.60950202
SIMANGAMBAT,50,793,229,84,1106,49,67,136,252,1358,1.518881793,100.0931017
HALONGONAN,60,1045,383,181,1609,25,35,137,197,1806,1.628709641,99.77719186
DOLOK,70,1268,333,141,1742,45,108,248,401,2143,1.843285602,99.67427045
DOLOK SIGOMPULON,80,791,199,74,1064,15,96,163,274,1338,1.969207589,99.70074838
HULU SIHAPAS,90,459,176,110,745,13,25,71,109,854,1.457086258,99.42497153
SOSOPAN,10,734,312,172,1218,9,23,67,99,1317,1.205218286,99.55848067
ULU BARUMUN,20,1378,546,306,2230,57,67,152,276,2506,1.072281865,99.63321323
BARUMUN,30,2882,1010,558,4450,100,216,390,706,5156,0.988718545,99.70307909
BARUMUN SELATAN,31,616,177,83,876,15,62,97,174,1050,,
LUBUK BARUMUN,40,1254,398,168,1820,34,83,187,304,2124,1.160174275,99.78677409
SOSA,50,2408,803,393,3604,44,110,299,453,4057,1.006506522,99.87434396
BATANG LUBU SUTAM,60,613,128,27,768,27,73,109,209,977,0.908875668,100.067545
HUTA RAJA TINGGI,70,785,237,81,1103,14,54,112,180,1283,1.147083781,100.0364951
HURISTAK,80,821,204,84,1109,50,110,157,317,1426,1.381952308,99.90842138
BARUMUN TENGAH,90,1587,523,248,2358,45,80,176,301,2659,1.305003186,99.75125471
AEK NABARA BARUMUN,91,800,294,161,1255,19,34,104,157,1412,,
SUNGAI KANAN,10,1759,643,315,2717,78,194,452,724,3441,1.734418785,99.87588892
TORGAMBA,20,2345,825,353,3523,98,227,511,836,4359,1.700919,100.2479221
KOTA PINANG,30,1303,459,256,2018,259,191,338,788,2806,1.886502917,100.0778773
SILANGKITANG,40,901,349,158,1408,34,84,256,374,1782,1.870407652,99.93789219
KAMPUNG RAKYAT,50,1305,521,261,2087,81,134,318,533,2620,2.066532882,100.2129265
NA IX-X,10,1627,561,246,2434,81,141,316,538,2972,2.169043046,99.66153545
MARBAU,20,1224,441,203,1868,61,125,289,475,2343,2.246238383,99.86326696
AEK KUO,30,1337,455,123,1915,52,106,243,401,2316,2.373050153,99.85705151
AEK NATAS,40,1431,652,408,2491,158,44,121,323,2814,2.292523724,99.60542836
KUALUH SELATAN,50,2771,1182,535,4488,157,206,582,945,5433,2.471691063,99.64918422
KUALUH HILIR,60,2442,1025,403,3870,285,283,713,1281,5151,2.541287485,99.96720177
KUALUH HULU,70,1643,593,234,2470,88,212,431,731,3201,2.549316188,99.63923339
KUALUH LEIDONG,80,1575,599,277,2451,524,350,547,1421,3872,2.697957646,99.91590914
TUGALA OYO,10,702,199,91,992,107,120,187,414,1406,1.123083418,97.42621414
ALASA,20,2922,893,425,4240,98,190,376,664,4904,1.198927848,97.39191316
ALASA TALU MUZOI,30,865,325,196,1386,30,49,128,207,1593,1.253067779,97.45755806
NAMOHALU ESIWA,40,1861,549,207,2617,110,142,339,591,3208,1.328925234,97.42031538
SITOLU ORI,50,1591,627,350,2568,91,114,242,447,3015,1.405103353,97.4479249
TUHEMBERUA,60,1548,534,307,2389,59,102,227,388,2777,1.44894558,97.4626861
SAWO,70,1402,440,264,2106,72,91,188,351,2457,1.493854324,97.38523257
LOTU,80,1732,649,352,2733,59,86,282,427,3160,1.421255606,97.36270223
LAHEWA TIMUR,90,1556,526,245,2327,59,123,275,457,2784,1.355467541,97.31496492
AFULU,100,1323,453,287,2063,239,121,244,604,2667,1.255417633,97.28182925
LAHEWA,110,2485,920,518,3923,134,181,356,671,4594,1.36995034,97.19520525
SIROMBU,10,1048,417,222,1687,131,107,232,470,2157,0.92292546,97.45091555
LAHOMI,20,837,325,226,1388,45,56,102,203,1591,0.977017596,97.50952809
ULU MORO O,30,987,357,169,1513,85,111,194,390,1903,1.025645042,97.5536139
LOLOFITU MOI,40,1201,440,264,1905,93,157,213,463,2368,1.078360812,97.60182733
MANDREHE UTARA,50,1180,399,221,1800,46,83,169,298,2098,1.1160806,97.52065731
MANDREHE,60,2388,964,574,3926,52,97,298,447,4373,1.051775689,97.50718585
MANDREHE BARAT,70,1101,384,227,1712,34,80,155,269,1981,1.014813241,97.43026386
MORO O,80,1158,459,266,1883,108,64,135,307,2190,1.072555762,97.42384303
SIBOLGA UTARA,10,1372,581,348,2301,29,51,201,281,2582,1.748034562,98.78437398
SIBOLGA KOTA,20,650,254,151,1055,12,20,115,147,1202,1.727686037,98.77432644
SIBOLGA SELATAN,30,1678,656,358,2692,35,105,295,435,3127,1.730787927,98.79894113
SIBOLGA SAMBAS,31,1171,423,214,1808,34,77,230,341,2149,1.732577781,98.78629856
DATUK BANDAR,10,1814,727,385,2926,69,147,346,562,3488,2.946861769,99.77849003
DATUK BANDAR TIMUR,11,1807,757,345,2909,80,181,433,694,3603,2.944820685,99.81729148
TANJUNG BALAI SELATAN,20,416,190,113,719,15,17,99,131,850,2.962674747,99.80220448
TANJUNG BALAI UTARA,30,1233,511,289,2033,36,84,255,375,2408,2.970258892,99.80200284
SEI TUALANG RASO,40,1990,842,443,3275,66,163,377,606,3881,2.988898844,99.78451876
TELUK NIBUNG,50,3009,1240,675,4924,123,285,646,1054,5978,3.002399888,99.80434922
SIANTAR MARIHAT,10,921,414,257,1592,9,7,133,149,1741,2.944137534,99.08450457
SIANTAR MARIMBUN,11,838,365,255,1458,19,8,105,132,1590,2.922448294,99.04892963
SIANTAR SELATAN,20,590,298,171,1059,15,12,98,125,1184,2.947593041,99.06132486
SIANTAR BARAT,30,1036,438,275,1749,24,31,145,200,1949,2.956296442,99.05627808
SIANTAR UTARA,40,1787,752,412,2951,25,58,270,353,3304,2.97042618,99.06421979
SIANTAR TIMUR,50,1561,684,416,2661,17,28,204,249,2910,2.962211705,99.07903378
SIANTAR MARTOBA,60,2322,1047,507,3876,43,103,430,576,4452,2.996222207,99.07750659
SIANTAR SITALASARI,61,968,430,201,1599,15,25,188,228,1827,2.97321262,99.03904901
PADANG HULU,10,819,350,176,1345,21,67,203,291,1636,3.303071273,99.13849703
TEBING TINGGI KOTA,11,749,340,170,1259,18,29,174,221,1480,3.326849858,99.16131502
RAMBUTAN,20,1399,609,296,2304,15,79,303,397,2701,3.35312249,99.16541016
BAJENIS,21,1406,646,260,2312,37,83,402,522,2834,3.332748344,99.13721503
PADANG HILIR,30,1221,530,241,1992,28,58,284,370,2362,3.327383669,99.17778119
MEDAN TUNTUNGAN,10,1589,660,344,2593,59,91,330,480,3073,3.518177123,98.62229188
MEDAN JOHOR,20,3511,1483,767,5761,55,179,647,881,6642,3.529244556,98.66963624
MEDAN AMPLAS,30,2735,1242,614,4591,33,63,525,621,5212,3.538925416,98.7123476
MEDAN DENAI,40,4381,1824,987,7192,103,190,881,1174,8366,3.573198852,98.72072259
MEDAN AREA,50,1681,711,390,2782,33,63,349,445,3227,3.579173984,98.70047887
MEDAN KOTA,60,1502,651,351,2504,24,44,251,319,2823,3.569626226,98.69489569
MEDAN MAIMUN,70,1344,593,293,2230,32,60,274,366,2596,3.567829017,98.68345084
MEDAN POLONIA,80,1498,650,294,2442,42,86,294,422,2864,3.560093017,98.6730166
MEDAN BARU,90,370,170,86,626,2,16,67,85,711,3.567490835,98.65867766
MEDAN SELAYANG,100,1713,742,448,2903,66,77,316,459,3362,3.552559847,98.63394114
MEDAN SUNGGAL,110,2486,1014,491,3991,170,206,598,974,4965,3.580590488,98.62707946
MEDAN HELVETIA,120,2753,1199,718,4670,100,127,547,774,5444,3.605503717,98.63242688
MEDAN PETISAH,130,940,445,205,1590,18,39,208,265,1855,3.59236954,98.65980057
MEDAN BARAT,140,1538,762,360,2660,117,85,328,530,3190,3.608302134,98.66846231
MEDAN TIMUR,150,2127,1001,496,3624,48,87,425,560,4184,3.619181758,98.68178277
MEDAN PERJUANGAN,160,2490,1120,684,4294,50,90,450,590,4884,3.603380164,98.69331882
MEDAN TEMBUNG,170,3246,1494,734,5474,88,161,660,909,6383,3.605708385,98.71123399
MEDAN DELI,180,5068,2111,979,8158,137,327,1206,1670,9828,3.660489919,98.67519405
MEDAN LABUHAN,190,4721,1886,909,7516,281,362,1108,1751,9267,3.719017081,98.69495636
MEDAN MARELAN,200,5724,2174,1125,9023,243,442,1275,1960,10983,3.711842916,98.65509786
MEDAN KOTA BELAWAN,210,7238,2674,1164,11076,308,638,1586,2532,13608,3.767166951,98.66850747
BINJAI SELATAN,10,1859,805,395,3059,52,121,468,641,3700,3.564798324,98.47149905
BINJAI KOTA,20,751,314,173,1238,15,31,150,196,1434,3.600131969,98.47707658
BINJAI TIMUR,30,1996,855,423,3274,64,146,494,704,3978,3.595144371,98.5167145
BINJAI UTARA,40,1871,836,422,3129,53,122,432,607,3736,3.642906776,98.49825367
BINJAI BARAT,50,1525,587,290,2402,40,141,382,563,2965,3.618369199,98.46854282
PADANGSIDIMPUAN TENGGARA,10,1209,517,313,2039,93,79,234,406,2445,1.332970078,99.31710694
PADANGSIDIMPUAN SELATAN,20,2190,837,526,3553,77,114,300,491,4044,1.373152606,99.2773735
PADANGSIDIMPUAN BATUNADUA,30,969,452,225,1646,20,44,147,211,1857,1.40555603,99.2987643
PADANGSIDIMPUAN UTARA,40,1539,709,406,2654,31,63,219,313,2967,1.394353398,99.25955086
PADANGSIDIMPUAN HUTAIMBARU,50,818,359,228,1405,13,37,116,166,1571,1.425497375,99.24061169
PADANGSIDIMPUAN ANGKOLA JULU,51,591,250,181,1022,5,30,111,146,1168,1.448319762,99.26749951
GUNUNGSITOLI IDANOI,10,2500,1019,687,4206,276,215,462,953,5159,1.15348009,97.64589558
GUNUNGSITOLI SELATAN,20,1316,555,359,2230,87,81,199,367,2597,1.216015837,97.62784809
GUNUNGSITOLI BARAT,30,714,284,197,1195,46,55,158,259,1454,1.225489277,97.58820432
GUNUNG SITOLI,40,3803,1509,931,6243,160,232,566,958,7201,1.279358037,97.59847417
GUNUNGSITOLI ALO OA,50,736,284,160,1180,51,72,145,268,1448,1.307402782,97.53581508
GUNUNGSITOLI UTARA,60,1762,703,449,2914,152,159,331,642,3556,1.364131476,97.52065771
PAGAI SELATAN,11,464,100,39,603,62,30,48,140,743,-3.049049127,100.3398972
SIKAKAP,12,267,66,25,358,14,6,14,34,392,-2.756087747,100.1469353
PAGAI UTARA,13,241,45,20,306,10,13,18,41,347,-2.66840822,100.0385507
SIPORA SELATAN,21,495,157,67,719,30,20,21,71,790,-2.243999368,99.71789754
SIPORA UTARA,22,191,63,22,276,142,32,27,201,477,-2.141108074,99.60612366
SIBERUT SELATAN,30,477,153,76,706,110,48,69,227,933,-1.528981978,99.05769677
SEBERUT BARAT DAYA,31,177,30,7,214,129,36,35,200,414,-1.674422608,99.04860346
SIBERUT TENGAH,32,207,33,10,250,30,21,29,80,330,-1.363647887,99.05135472
SIBERUT UTARA,40,229,48,25,302,94,18,20,132,434,-1.187379787,98.8833261
SIBERUT BARAT,41,284,42,18,344,100,44,53,197,541,-1.208832087,98.7643424
LUNANG SILAUT,10,862,304,257,1423,72,43,91,206,1629,-2.297657876,101.0966344
BASA AMPEK BALAI TAPAN,20,1297,405,279,1981,51,92,216,359,2340,-2.135374802,101.0922259
PANCUNG SOAL,30,1714,717,493,2924,91,78,198,367,3291,-2.014110293,101.0147374
LINGGO SARI BAGANTI,40,2393,852,474,3719,106,183,424,713,4432,-1.821067429,100.9866386
RANAH PESISIR,50,1652,647,439,2738,49,89,227,365,3103,-1.686360413,100.9214406
LENGAYANG,60,2814,1168,782,4764,77,118,360,555,5319,-1.574354346,100.8303478
SUTERA,70,2370,907,508,3785,151,163,303,617,4402,-1.455159451,100.7524416
BATANG KAPAS,80,1831,783,443,3057,56,86,260,402,3459,-1.391562751,100.6664245
IV JURAI,90,1546,598,363,2507,47,69,202,318,2825,-1.265172479,100.6624517
BAYANG,100,1765,828,538,3131,33,37,207,277,3408,-1.257995729,100.532867
IV  NAGARI BAYANG UTARA,101,628,276,229,1133,11,9,38,58,1191,-1.149958714,100.6408119
KOTO XI TARUSAN,110,2469,1056,628,4153,70,156,366,592,4745,-1.133499606,100.4840388
PANTAI CERMIN,40,1060,403,189,1652,60,95,173,328,1980,-1.238576713,100.8821726
LEMBAH GUMANTI,50,2596,769,330,3695,132,244,515,891,4586,,
HILIRAN GUMANTI,51,1132,464,285,1881,35,49,150,234,2115,-1.145085283,100.935356
PAYUNG SEKAKI,60,358,139,61,558,7,23,69,99,657,-0.880363946,100.8309818
TIGO LURAH,61,879,279,108,1266,82,99,132,313,1579,-1.021882874,101.0235878
LEMBANG JAYA,70,1735,598,317,2650,88,153,345,586,3236,-0.965101848,100.7186109
DANAU KEMBAR,71,1083,327,138,1548,64,127,246,437,1985,-1.054642887,100.6954548
GUNUNG TALANG,80,1796,661,291,2748,136,191,382,709,3457,-0.96372727,100.6218311
BUKIT SUNDI,90,973,336,154,1463,55,73,169,297,1760,-0.882603437,100.7234931
IX KOTO SUNGAI LASI,100,410,173,107,690,16,17,42,75,765,-0.790341536,100.7579446
KUBUNG,110,1801,697,316,2814,67,146,322,535,3349,-0.819052401,100.6064387
X KOTO DIATAS,120,820,442,273,1535,165,66,147,378,1913,-0.628177184,100.6559798
X KOTO SINGKARAK,130,1104,511,295,1910,47,59,189,295,2205,-0.710692766,100.5724701
JUNJUNG SIRIH,140,681,313,169,1163,20,48,68,136,1299,-0.679939536,100.4936154
KAMANG BARU,50,1898,603,303,2804,101,190,379,670,3474,-0.781801018,101.3101069
TANJUNG GADANG,60,1451,456,193,2100,114,143,295,552,2652,-0.850938367,101.1378053
SIJUNJUNG,70,1599,546,303,2448,84,178,287,549,2997,-0.61507375,101.0583006
LUBUK TAROK,71,1031,288,134,1453,35,71,127,233,1686,-0.793736095,100.9979501
IV NAGARI,80,182,80,50,312,7,15,29,51,363,-0.727242167,100.8882001
KUPITAN,90,494,179,108,781,20,17,44,81,862,-0.706679239,100.8327129
KOTO TUJUH,100,1172,349,149,1670,87,155,206,448,2118,-0.596080727,100.8465054
SUMPUR KUDUS,110,1083,321,171,1575,60,114,185,359,1934,-0.434758134,100.9318674
SEPULUH KOTO,10,2085,876,410,3371,79,189,355,623,3994,-0.450694116,100.3823655
BATIPUH,20,1607,726,399,2732,62,108,205,375,3107,-0.492119743,100.4562982
BATIPUH SELATAN,21,851,365,187,1403,20,42,119,181,1584,,
PARIANGAN,30,765,350,183,1298,19,40,89,148,1446,-0.448848288,100.5007759
RAMBATAN,40,1851,745,382,2978,65,124,282,471,3449,-0.523760841,100.5730172
LIMA KAUM,50,785,337,155,1277,17,48,103,168,1445,-0.458655779,100.5659875
TANJUNG EMAS,60,864,366,186,1416,40,48,110,198,1614,-0.479559792,100.6590521
PADANG GANTING,70,562,186,69,817,24,52,64,140,957,-0.527655906,100.7215709
LINTAU BUO,80,954,366,170,1490,47,47,111,205,1695,-0.488199341,100.7908677
LINTAU BUO UTARA,81,1789,678,352,2819,79,144,289,512,3331,-0.395148905,100.7375922
SUNGAYANG,90,776,341,162,1279,16,62,141,219,1498,-0.380191383,100.6172507
SUNGAI TARAB,100,1299,505,204,2008,31,97,256,384,2392,-0.402114518,100.5398003
SALIMPAUNG,110,1055,422,209,1686,37,60,166,263,1949,-0.343706453,100.5562022
TANJUNG BARU,111,767,315,156,1238,25,31,104,160,1398,-0.314075878,100.5291011
BATANG ANAI,10,1294,567,198,2059,135,162,346,643,2702,-0.753159479,100.3155443
LUBUK ALUNG,20,1512,620,307,2439,105,170,320,595,3034,-0.689654201,100.3547498
SINTUK TOBOH GADANG,21,1276,534,274,2084,81,103,207,391,2475,-0.668785361,100.2505364
ULAKAN TAPAKIS,30,1440,661,292,2393,62,92,251,405,2798,-0.700969676,100.2161701
NAN SABARIS,40,1446,650,399,2495,38,79,182,299,2794,-0.653020384,100.1910788
2 X 11 ENAM LINGKUNG,50,720,302,136,1158,32,54,103,189,1347,-0.589013712,100.2840288
ENAM LINGKUNG,51,865,322,180,1367,22,46,100,168,1535,-0.629658179,100.2666606
2 X 11 KAYU TANAM,52,1434,554,296,2284,63,117,271,451,2735,-0.570346572,100.3542198
VII KOTO SUNGAI SARIAK,60,1796,788,351,2935,84,116,301,501,3436,-0.585613514,100.197658
PATAMUAN,61,1127,466,212,1805,56,74,139,269,2074,-0.505574448,100.2648326
PADANG SAGO,62,423,187,64,674,13,34,88,135,809,-0.535361273,100.209299
V KOTO KP DALAM,70,1063,499,229,1791,58,100,234,392,2183,-0.481055953,100.1518918
V KOTO TIMUR,71,495,229,109,833,22,31,96,149,982,-0.488458327,100.1883806
SUNGAI LIMAU,80,2165,991,466,3622,58,129,397,584,4206,-0.506365645,100.0772718
BATANG GASAN,81,856,363,185,1404,32,80,181,293,1697,-0.437228809,100.0142755
SUNGAI GERINGGING,90,1502,606,193,2301,79,148,339,566,2867,-0.436611171,100.1058299
IV KOTO AUR MALINTANG,100,1541,528,281,2350,80,126,261,467,2817,-0.369439996,100.0796434
TANJUNG MUTIARA,10,1571,650,325,2546,63,136,283,482,3028,-0.290587457,99.87985562
LUBUK BASUNG,20,3223,1348,651,5222,126,329,620,1075,6297,-0.292754984,100.0092389
IV NAGARI,21,1465,536,296,2297,51,102,287,440,2737,-0.200106275,100.0012361
TANJUNG RAYA,30,1538,656,330,2524,66,121,250,437,2961,-0.312770445,100.186093
MATUR,40,1088,555,300,1943,40,51,125,216,2159,-0.278510454,100.2804503
IV KOTO,50,1107,514,269,1890,44,115,207,366,2256,-0.334260732,100.3188071
MALALAK,51,521,263,175,959,26,62,146,234,1193,-0.413078357,100.2718914
BANUHAMPU,61,1034,480,258,1772,31,78,163,272,2044,-0.348696934,100.3740466
SUNGAI PUA,62,918,374,226,1518,29,71,149,249,1767,-0.373451583,100.4053005
IV ANGKAT CANDUNG,70,1077,487,295,1859,36,52,134,222,2081,-0.289558054,100.4252034
CANDUANG,71,1030,467,349,1846,28,46,134,208,2054,-0.336960383,100.4529987
BASO,80,1515,686,427,2628,39,90,220,349,2977,-0.271314645,100.4887755
TILATANG KAMANG,90,1022,458,287,1767,47,39,114,200,1967,-0.251110374,100.3793076
KAMANG MAGEK,91,883,398,314,1595,19,44,112,175,1770,-0.196326351,100.4104911
PALEMBAYAN,100,2399,864,457,3720,82,205,411,698,4418,-0.159058157,100.1670756
PALUPUH,110,1134,515,315,1964,81,76,245,402,2366,-0.125045546,100.2997297
PAYAKUMBUH,10,1842,757,335,2934,39,120,283,442,3376,-0.171380081,100.591312
AKABILURU,11,1556,641,360,2557,56,79,196,331,2888,-0.221596746,100.5193525
LUAK,20,1204,457,202,1863,26,78,215,319,2182,-0.268905386,100.6786901
LAREH SAGO HALABAN,21,1625,607,281,2513,93,135,287,515,3028,-0.294316808,100.7616601
SITUJUAH LIMO NAGARI,22,1009,394,231,1634,43,71,165,279,1913,-0.311235327,100.6263807
HARAU,30,2201,828,468,3497,160,132,320,612,4109,-0.119553041,100.6956616
GUGUAK,40,1288,473,255,2016,37,67,140,244,2260,-0.140885995,100.5267393
MUNGKA,41,835,344,137,1316,58,125,197,380,1696,-0.057615228,100.5813348
SULIKI,50,678,221,111,1010,26,69,124,219,1229,-0.109656297,100.4456855
BUKIK BARISAN,51,1390,530,207,2127,54,104,276,434,2561,0.029218558,100.4566616
GUNUANG OMEH,60,865,302,95,1262,34,83,143,260,1522,-0.040627271,100.3498835
KAPUR IX,70,1279,488,223,1990,64,127,276,467,2457,0.239511591,100.4461874
PANGKALAN KOTO BARU,80,1286,531,278,2095,100,91,238,429,2524,0.099909759,100.7018049
BONJOL,70,1479,635,357,2471,60,112,263,435,2906,0.005514873,100.2421878
TIGO NAGARI,71,2246,691,328,3265,115,280,513,908,4173,0.006529471,100.0696938
SIMPANG ALAHAN MATI,72,727,297,116,1140,16,47,144,207,1347,-0.00774685,100.1614687
LUBUK SIKAPING,80,2061,753,300,3114,65,176,415,656,3770,0.153385835,100.1274874
DUA KOTO,100,2447,926,496,3869,127,221,467,815,4684,0.37406915,99.90256803
PANTI,110,2163,735,292,3190,105,194,333,632,3822,0.352739001,100.0934911
PADANG GELUGUR,111,1237,457,197,1891,38,62,160,260,2151,0.428098666,100.0512017
RAO,121,1357,498,196,2051,34,61,178,273,2324,0.557986312,99.97870915
MAPAT TUNGGUL,122,868,284,144,1296,48,52,131,231,1527,0.679935916,100.1513994
MAPAT TUNGGUL SELATAN,123,722,193,93,1008,64,128,186,378,1386,0.321221097,100.2369295
RAO SELATAN,124,1393,464,199,2056,43,75,189,307,2363,0.522693385,100.061584
RAO UTARA,125,1067,355,192,1614,37,64,144,245,1859,0.738555537,99.96596037
SANGIR,10,1721,639,312,2672,95,141,313,549,3221,-1.594333257,101.2764067
SANGIR JUJUAN,20,280,162,94,536,14,22,48,84,620,-1.42471413,101.3146524
SANGIR BALAI JANGGO,21,300,119,69,488,26,30,69,125,613,-1.444262247,101.501867
SANGIR BATANG HARI,30,587,240,115,942,27,44,98,169,1111,-1.231317811,101.3481535
SUNGAI PAGU,40,1100,440,284,1824,60,77,154,291,2115,-1.47035286,101.0807979
PAUAH DUO,41,1160,428,248,1836,45,82,145,272,2108,-1.564008729,101.1099928
KOTO PARIK GADANG DIATEH,50,1367,520,314,2201,106,117,244,467,2668,-1.31338419,101.0585816
SUNGAI RUMBAI,10,440,144,56,640,29,40,99,168,808,-1.213991115,101.7427159
KOTO BESAR,11,804,235,122,1161,38,67,127,232,1393,-1.2284544,101.5766681
ASAM JUJUHAN,12,487,120,37,644,31,53,88,172,816,-1.500812064,101.5924146
KOTO BARU,20,910,316,170,1396,37,71,159,267,1663,-1.120500596,101.6882729
KOTO SALAK,21,726,246,125,1097,12,32,89,133,1230,-1.149353044,101.8105218
TIUMANG,22,290,98,25,413,4,12,43,59,472,-1.055668989,101.7417015
PADANG LAWEH,23,181,48,24,253,3,13,29,45,298,-1.027156092,101.7852671
SITIUNG,30,934,367,187,1488,43,37,141,221,1709,-1.002914674,101.6274497
TIMPEH,31,361,144,78,583,9,23,60,92,675,-0.889825253,101.6053261
PULAU PUNJUNG,40,1338,533,307,2178,44,70,231,345,2523,-1.019668166,101.4952663
IX KOTO,41,801,259,100,1160,23,51,111,185,1345,-1.031211711,101.2831183
SUNGAI BEREMAS,10,1842,743,372,2957,59,119,314,492,3449,0.261599225,99.34611872
RANAH BATAHAN,20,1388,509,311,2208,40,93,222,355,2563,0.434031503,99.46043008
KOTO BALINGKA,30,1932,691,357,2980,65,127,318,510,3490,0.313410541,99.51106969
SUNGAI AUR,40,1926,664,370,2960,87,121,282,490,3450,0.247969068,99.62733295
LEMBAH MALINTANG,50,2485,962,542,3989,92,157,386,635,4624,0.357598635,99.58725162
GUNUNG TULEH,60,1296,573,372,2241,44,100,216,360,2601,0.317410121,99.75243951
TALAMAU,70,1969,783,433,3185,111,256,505,872,4057,0.211786286,99.943023
PASAMAN,80,2065,711,399,3175,202,318,517,1037,4212,0.12038808,99.8095749
LUHAK NAN DUO,90,1115,428,213,1756,80,116,209,405,2161,0.037054187,99.79687362
SASAK RANAH PASISIE,100,838,407,234,1479,59,106,232,397,1876,0.059916446,99.65351497
KINALI,110,2937,907,439,4283,134,329,638,1101,5384,-0.066978777,99.8917764
BUNGUS TELUK KABUNG,10,1536,642,403,2581,51,105,288,444,3025,-1.050616919,100.4167354
LUBUK KILANGAN,20,1230,574,300,2104,35,63,183,281,2385,-0.956854923,100.494536
LUBUK BEGALUNG,30,3644,1626,806,6076,72,127,558,757,6833,-0.97994572,100.4026523
PADANG SELATAN,40,2493,1028,564,4085,89,126,398,613,4698,-0.977533961,100.3590288
PADANG TIMUR,50,2432,1123,648,4203,78,87,354,519,4722,-0.945211201,100.3783419
PADANG BARAT,60,1719,711,394,2824,27,48,251,326,3150,-0.943622076,100.3565051
PADANG UTARA,70,1370,603,343,2316,31,42,188,261,2577,-0.912659088,100.3578299
NANGGALO,80,1496,676,376,2548,18,41,204,263,2811,-0.899363009,100.3715799
KURANJI,90,4549,2295,1321,8165,96,164,604,864,9029,-0.895427982,100.4146585
PAUH,100,2088,966,498,3552,46,74,336,456,4008,-0.878095649,100.4908918
KOTO TANGAH,110,6166,2858,1704,10728,193,296,1012,1501,12229,-0.809132664,100.404862
LUBUK SIKARAH,10,1256,517,275,2048,45,85,215,345,2393,-0.794980906,100.610807
TANJUNG HARAPAN,20,853,331,192,1376,33,28,148,209,1585,-0.762621212,100.6609174
SILUNGKANG,10,226,67,25,318,13,25,42,80,398,-0.733469775,100.787027
LEMBAH SEGAR,20,118,58,30,206,4,13,25,42,248,-0.695532093,100.761245
BARANGIN,30,378,144,57,579,7,23,63,93,672,-0.658665641,100.7260955
TALAWI,40,148,73,26,247,3,11,19,33,280,-0.602652968,100.7678409
PADANG PANJANG BARAT,10,955,354,230,1539,32,44,121,197,1736,-0.471681104,100.3887501
PADANG PANJANG TIMUR,20,921,396,259,1576,26,45,145,216,1792,-0.470713344,100.4184933
GUGUK PANJANG,10,1060,393,226,1679,36,57,122,215,1894,-0.304706204,100.3670964
MANDIANGIN KOTO SELAYAN,20,1102,423,250,1775,39,56,128,223,1998,-0.290729352,100.3672577
AUR BIRUGO TIGO BALEH,30,368,146,79,593,13,19,45,77,670,-0.316601817,100.3877046
PAYAKUMBUH BARAT,10,1727,696,386,2809,40,96,231,367,3176,-0.23574762,100.6109935
PAYAKUMBUH SELATAN,11,426,162,107,695,5,13,55,73,768,-0.260778405,100.6259042
PAYAKUMBUH TIMUR,20,866,353,210,1429,13,40,109,162,1591,-0.222209042,100.6611791
PAYAKUMBUH UTARA,30,1248,516,336,2100,22,66,159,247,2347,-0.205195586,100.6407122
PAYAKUMBUH LAMPOSI TIGO NAGORI,31,641,265,151,1057,29,35,71,135,1192,-0.204120511,100.6030494
PARIAMAN SELATAN,10,831,337,192,1360,18,22,108,148,1508,-0.639368727,100.1578332
PARIAMAN TENGAH,20,850,303,183,1336,20,32,100,152,1488,-0.626003,100.1308442
PARIAMAN TIMUR,21,814,343,201,1358,13,27,100,140,1498,-0.603493806,100.1456994
PARIAMAN UTARA,30,1086,456,265,1807,9,39,175,223,2030,-0.576021671,100.1177594
KUANTAN MUDIK,10,1225,441,299,1965,25,55,154,234,2199,-0.77979673,101.6415604
HULU KUANTAN,11,369,149,97,615,16,26,59,101,716,-0.581933023,101.351514
GUNUNG TOAR,12,513,190,147,850,16,28,61,105,955,-0.601377095,101.5135751
SINGINGI,20,771,256,142,1169,36,52,112,200,1369,-0.436795617,101.2763207
SINGINGI HILIR,21,828,224,87,1139,55,103,203,361,1500,-0.218307171,101.3026832
KUANTAN TENGAH,30,1072,499,352,1923,52,51,145,248,2171,-0.563909282,101.6049224
BENAI,40,968,378,234,1580,24,44,150,218,1798,-0.419649634,101.5878518
KUANTAN HILIR,50,345,131,66,542,31,41,103,175,717,-0.472017019,101.7698718
PANGEAN,51,795,342,226,1363,20,45,126,191,1554,-0.462795284,101.6896982
LOGAS TANAH DARAT,52,448,136,82,666,44,48,87,179,845,-0.254303246,101.588111
CERENTI,60,507,191,94,792,23,45,90,158,950,-0.499156423,101.8637217
INUMAN,61,517,242,160,919,20,36,93,149,1068,-0.488303672,101.8009812
PERANAP,10,692,235,117,1044,42,81,175,298,1342,-0.684688145,101.990522
BATANG PERANAP,11,379,141,34,554,6,49,92,147,701,-0.730827934,101.8674549
SEBERIDA,20,746,225,117,1088,71,88,158,317,1405,-0.573438859,102.4411409
BATANG CENAKU,21,744,223,85,1052,104,93,167,364,1416,-0.794209046,102.2349386
BATANG GANSAL,22,836,233,65,1134,223,165,257,645,1779,-0.81335236,102.4992332
KELAYANG,30,1122,414,279,1815,163,156,223,542,2357,-0.448221932,102.0812526
RAKIT KULIM,31,1189,389,214,1792,458,269,385,1112,2904,-0.591003898,102.1674126
PASIR PENYU,40,928,432,304,1664,36,37,119,192,1856,-0.368196021,102.277312
LIRIK,41,491,163,106,760,78,67,105,250,1010,-0.259479103,102.2719731
SUNGAI LALA,42,506,182,106,794,59,76,146,281,1075,-0.432588235,102.2566897
LUBUK BATU JAYA,43,213,74,46,333,58,24,57,139,472,-0.342342637,102.1247887
RENGAT BARAT,50,930,306,140,1376,63,102,221,386,1762,-0.338418247,102.4233501
RENGAT,60,749,287,144,1180,85,105,180,370,1550,-0.202186923,102.5424159
KUALA CENAKU,61,505,197,131,833,39,68,121,228,1061,-0.189015783,102.6594158
KERITANG,10,1386,408,169,1963,225,242,382,849,2812,-0.697136019,102.8418965
KEMUNING,11,467,90,45,602,302,182,170,654,1256,-0.925995576,102.7097915
RETEH,20,1282,442,181,1905,144,174,325,643,2548,-0.715406807,103.2601436
SUNGAI BATANG,21,477,209,72,758,44,64,127,235,993,-0.614406002,103.2223282
ENOK,30,1400,453,181,2034,110,197,373,680,2714,-0.507237389,103.1281347
TANAH MERAH,40,1218,333,111,1662,108,184,313,605,2267,-0.475122058,103.3531832
KUALA INDRAGIRI,50,753,169,63,985,227,249,313,789,1774,-0.335119634,103.4761792
CONCONG,51,612,162,73,847,79,126,176,381,1228,-0.284159796,103.5926557
TEMBILAHAN,60,1047,308,133,1488,121,206,357,684,2172,-0.340149545,103.1812632
TEMBILAHAN HULU,61,1388,497,271,2156,198,203,287,688,2844,-0.383716673,103.0866558
TEMPULING,70,1022,284,90,1396,135,243,385,763,2159,-0.41132853,102.9000689
KEMPAS,71,802,263,116,1181,186,128,260,574,1755,-0.471284185,102.8040911
BATANG TUAKA,80,1321,439,178,1938,145,182,299,626,2564,-0.267920623,103.1209519
GAUNG ANAK SERKA,90,761,231,106,1098,63,107,213,383,1481,-0.193253248,103.1563746
GAUNG,100,1485,570,262,2317,251,250,467,968,3285,-0.054045055,102.989819
MANDAH,110,1777,577,206,2560,144,301,546,991,3551,0.079060867,103.3280966
KATEMAN,120,858,267,106,1231,103,138,241,482,1713,0.2334282,103.6554906
PELANGIRAN,121,546,139,55,740,171,176,254,601,1341,0.20391238,103.3507836
TELUK BELENGKONG,122,695,241,98,1034,43,94,215,352,1386,0.300080928,103.3456396
PULAU BURUNG,123,1051,427,204,1682,49,60,186,295,1977,0.415607187,103.3931033
LANGGAM,10,633,207,71,911,35,59,114,208,1119,0.082318874,101.6931409
PANGKALAN KERINCI,11,1318,409,178,1905,46,69,154,269,2174,0.362486713,101.8487377
BANDAR SEIKIJANG,12,535,177,79,791,31,46,90,167,958,0.416972364,101.6870077
PANGKALAN KURAS,20,1004,336,168,1508,116,124,198,438,1946,0.026565671,101.8803383
UKUI,21,835,242,73,1150,23,77,178,278,1428,-0.225219781,101.962168
PANGKALAN LESUNG,22,419,146,62,627,34,43,92,169,796,-0.024989775,102.1218912
BUNUT,30,336,160,89,585,80,39,49,168,753,0.284802121,102.1169554
PELALAWAN,31,336,92,46,474,31,31,67,129,603,0.45864252,102.1463515
BANDAR PETALANGAN,32,198,68,29,295,12,16,51,79,374,0.125564014,102.1898904
KUALA KAMPAR,40,737,274,119,1130,131,116,175,422,1552,0.569269324,103.1469996
KERUMUTAN,41,704,273,147,1124,30,56,115,201,1325,-0.000332451,102.3673632
TELUK MERANTI,42,830,297,138,1265,69,142,232,443,1708,0.383282103,102.6686596
MINAS,10,901,416,221,1538,40,47,142,229,1767,0.791541569,101.4664935
SUNGAI MANDAU,11,65,27,20,112,20,13,12,45,157,0.981145005,101.7106816
KANDIS,12,633,251,123,1007,116,53,122,291,1298,1.0006624,101.1656588
SIAK,20,296,121,56,473,10,17,44,71,544,0.879790205,101.9310506
KERINCI KANAN,21,342,150,85,577,13,6,41,60,637,0.491050198,101.7823552
TUALANG,22,2322,899,492,3713,51,60,206,317,4030,0.652728501,101.6310399
DAYUN,23,287,138,67,492,14,10,38,62,554,0.657818768,102.0705743
LUBUK DALAM,24,272,95,36,403,22,20,59,101,504,0.591758453,101.7876229
KOTO GASIB,25,426,172,94,692,10,17,78,105,797,0.73436676,101.7966739
MEMPURA,26,184,67,40,291,24,19,37,80,371,0.790047189,102.0569846
SUNGAI APIT,30,594,256,166,1016,86,73,145,304,1320,0.797003245,102.4193618
BUNGA RAYA,31,453,197,87,737,20,27,84,131,868,0.983072879,102.0500541
SABAK AUH,32,186,70,49,305,9,9,36,54,359,1.115080288,102.115098
PUSAKO,33,145,59,37,241,11,4,19,34,275,0.898975909,102.1530435
KAMPAR KIRI,10,1582,692,426,2700,140,114,254,508,3208,-0.008340021,101.1167586
KAMPAR KIRI HULU,11,983,406,305,1694,34,57,124,215,1909,-0.184577048,100.9425068
KAMPAR KIRI HILIR,12,461,196,123,780,21,12,43,76,856,0.125300918,101.4682507
GUNUNG SAHILAN,13,589,235,130,954,23,39,101,163,1117,0.028116303,101.3098428
KAMPAR KIRI TENGAH,14,1136,431,190,1757,50,74,185,309,2066,0.12926409,101.3317559
XIII KOTO KAMPAR,20,1489,660,508,2657,87,85,256,428,3085,0.268688393,100.7532044
KOTO KAMPAR HULU,21,1111,493,253,1857,65,39,139,243,2100,,
BANGKINANG BARAT,30,1035,474,256,1765,36,86,202,324,2089,0.343948357,100.9119875
SALO,31,1056,570,341,1967,104,55,140,299,2266,0.301824912,101.0064398
TAPUNG,40,2783,947,517,4247,90,158,392,640,4887,0.581428749,101.090722
TAPUNG HULU,41,2224,798,353,3375,147,186,437,770,4145,0.768429406,100.8201263
TAPUNG HILIR,42,1287,456,191,1934,78,92,217,387,2321,0.792388271,101.1289563
BANGKINANG,50,793,354,183,1330,11,23,76,110,1440,0.264968229,101.0729514
BANGKINANG SEBERANG,51,1697,762,396,2855,107,102,303,512,3367,0.439287134,101.0189756
KAMPAR,60,2423,1202,659,4284,51,119,371,541,4825,0.279235153,101.1267292
KAMPAR TIMUR,61,773,359,214,1346,136,57,145,338,1684,0.351875716,101.1971382
RUMBIO JAYA,62,687,321,206,1214,37,40,111,188,1402,0.421596178,101.1480019
KAMPAR UTARA,63,1029,491,321,1841,26,33,91,150,1991,0.408630846,101.0840939
TAMBANG,70,2220,935,518,3673,225,104,321,650,4323,0.372737881,101.3080422
SIAK HULU,80,2048,743,373,3164,199,156,287,642,3806,0.350576898,101.5505755
PERHENTIAN RAJA,81,489,176,90,755,21,40,92,153,908,0.317781754,101.4139458
ROKAN IV KOTO,10,886,325,145,1356,43,64,143,250,1606,0.583106229,100.3452163
PENDALIAN IV KOTO,11,254,83,22,359,3,18,36,57,416,0.502222317,100.4860512
TANDUN,20,565,236,105,906,12,35,78,125,1031,0.587281414,100.6077096
KABUN,21,344,124,59,527,29,45,100,174,701,0.46497689,100.7459928
UJUNG BATU,22,591,219,123,933,61,77,130,268,1201,0.692531541,100.5261972
RAMBAH SAMO,30,913,356,179,1448,85,88,164,337,1785,0.818433778,100.4340043
RAMBAH,40,835,320,218,1373,64,61,119,244,1617,0.826125742,100.2605715
RAMBAH HILIR,41,774,343,220,1337,70,46,110,226,1563,0.973464941,100.3606825
BANGUN PURBA,42,705,291,145,1141,27,63,109,199,1340,0.914821913,100.1868508
TAMBUSAI,50,1820,660,354,2834,140,146,276,562,3396,1.098678541,100.2599402
TAMBUSAI UTARA,51,1095,421,178,1694,101,79,219,399,2093,1.285533235,100.3141901
KEPENUHAN,60,423,162,86,671,89,46,63,198,869,1.132659469,100.623037
KEPENUHAN HULU,61,262,88,43,393,48,32,36,116,509,0.989619326,100.5150164
KUNTO DARUSSALAM,70,1058,358,187,1603,68,83,169,320,1923,0.919446284,100.6872915
PAGARAN TAPAH DARUSSALAM,71,319,115,42,476,13,20,50,83,559,0.769769869,100.6039702
BONAI DARUSSALAM,72,482,113,58,653,78,91,119,288,941,1.162583287,100.8361838
MANDAU,10,4150,1772,1063,6985,168,284,811,1263,8248,1.311376474,101.1822975
PINGGIR,11,2259,870,503,3632,79,135,424,638,4270,1.161501781,101.4428827
BUKIT BATU,20,1158,466,286,1910,33,64,220,317,2227,1.425927281,101.7939627
SIAK KECIL,21,635,228,155,1018,43,76,145,264,1282,1.17327347,101.9349466
RUPAT,30,1697,712,355,2764,101,178,440,719,3483,1.856899269,101.585957
RUPAT UTARA,31,743,229,130,1102,179,125,217,521,1623,2.02475865,101.5735158
BENGKALIS,40,2549,1043,646,4238,90,219,514,823,5061,1.450628295,102.2471385
BANTAN,50,1345,482,314,2141,304,199,352,855,2996,1.483199384,102.3392069
TANAH PUTIH,10,2745,1091,636,4472,61,183,516,760,5232,1.518117457,101.0331792
PUJUD,11,2846,877,445,4168,254,309,545,1108,5276,1.417014024,100.5986374
TANAH PUTIH TANJUNG MELAWAN,12,624,202,94,920,35,70,131,236,1156,1.704680094,101.1268414
RANTAU KOPAR,13,251,91,75,417,17,17,44,78,495,1.405453282,101.0296871
BAGAN SINEMBAH,20,3173,1189,610,4972,187,274,686,1147,6119,1.744469449,100.5432869
SIMPANG KANAN,21,820,259,97,1176,36,92,194,322,1498,1.875094639,100.3821051
KUBU,30,3099,1231,621,4951,81,293,665,1039,5990,2.035608439,100.5666251
PASIR LIMAU KAPAS,31,2242,745,388,3375,138,301,460,899,4274,2.203007466,100.3827653
BANGKO,40,4342,1836,1208,7386,251,386,912,1549,8935,2.079665977,100.8352738
SINABOI,41,1040,360,172,1572,80,130,252,462,2034,2.214664839,100.959627
BATU HAMPAR,42,619,271,161,1051,22,39,145,206,1257,1.949185458,100.9832896
PEKAITAN,43,682,246,133,1061,37,60,139,236,1297,,
RIMBA MELINTANG,50,1478,603,291,2372,66,128,354,548,2920,1.811410097,101.0131451
BANGKO PUSAKO,51,2442,955,507,3904,70,201,453,724,4628,1.731579389,100.8051532
TEBING TINGGI BARAT,10,1496,667,446,2609,129,126,287,542,3151,0.889824076,102.554503
TEBING TINGGI,20,2771,1262,789,4822,164,182,703,1049,5871,0.854844759,102.8280817
TEBING TINGGI TIMUR,21,838,434,295,1567,419,201,329,949,2516,,
RANGSANG,30,2357,930,551,3838,438,400,772,1610,5448,0.966779044,102.9872957
RANGSANG BARAT,40,2116,898,533,3547,128,282,618,1028,4575,1.088231238,102.7571554
MERBAU,50,2706,1150,652,4508,516,423,674,1613,6121,1.145414027,102.3760908
PULAU MERBAU,51,1526,633,411,2570,164,166,353,683,3253,,
TAMPAN,10,2868,951,531,4350,157,114,287,558,4908,0.466228875,101.3888306
PAYUNG SEKAKI,11,1764,735,403,2902,45,78,250,373,3275,0.525120469,101.3964356
BUKIT RAYA,20,1373,582,325,2280,40,72,182,294,2574,0.470787098,101.4677947
MARPOYAN DAMAI,21,2491,922,508,3921,56,102,384,542,4463,0.469579929,101.436235
TENAYAN RAYA,22,3583,1422,745,5750,204,220,598,1022,6772,0.510360323,101.5331323
LIMAPULUH,30,807,355,168,1330,19,32,92,143,1473,0.539274728,101.4587716
SAIL,40,397,161,95,653,12,11,66,89,742,0.51584828,101.4593586
PEKANBARU KOTA,50,682,305,181,1168,18,43,130,191,1359,0.523013075,101.4483231
SUKAJADI,60,1205,455,299,1959,30,42,146,218,2177,0.517189315,101.4377627
SENAPELAN,70,1208,472,269,1949,40,64,210,314,2263,0.535594774,101.4363742
RUMBAI,80,2455,899,482,3836,89,141,401,631,4467,0.615314916,101.3966169
RUMBAI PESISIR,81,1916,766,425,3107,49,94,295,438,3545,0.606124288,101.4985815
BUKIT KAPUR,10,1368,462,203,2033,69,151,347,567,2600,1.530974524,101.4144282
MEDANG KAMPAI,11,453,174,87,714,14,61,109,184,898,1.593093393,101.6029068
SUNGAI SEMBILAN,12,1422,496,235,2153,61,142,362,565,2718,1.931718028,101.2025114
DUMAI BARAT,20,1598,624,376,2598,62,123,343,528,3126,1.653025292,101.3925206
DUMAI TIMUR,30,1993,760,451,3204,45,123,403,571,3775,1.643519862,101.4542327
GUNUNG RAYA,10,782,304,146,1232,31,42,130,203,1435,-2.29932824,101.570901
BATANG MERANGIN,20,742,256,122,1120,28,47,120,195,1315,-2.130201207,101.6749465
KELILING DANAU,30,858,315,157,1330,39,42,105,186,1516,,
DANAU KERINCI,40,831,332,145,1308,28,43,134,205,1513,-2.032181578,101.5812276
SITINJAU LAUT,50,744,285,160,1189,18,23,132,173,1362,-2.057620403,101.4886431
AIR HANGAT,70,522,291,202,1015,33,47,74,154,1169,-1.917221007,101.5077187
AIR HANGAT TIMUR,71,622,263,112,997,54,46,134,234,1231,-1.986640927,101.487897
DEPATI VII,72,693,362,209,1264,22,36,105,163,1427,-2.019338356,101.3541066
GUNUNG KERINCI,80,686,292,102,1080,16,48,134,198,1278,-1.898649289,101.2554361
SIULAK,81,1446,629,311,2386,67,129,313,509,2895,-1.884345064,101.400762
KAYU ARO,90,1019,373,142,1534,85,129,222,436,1970,-1.778127183,101.2452624
GUNUNG TUJUH,91,594,234,82,910,39,46,92,177,1087,-1.728269261,101.3687685
JANGKAT,10,131,52,16,199,24,24,80,128,327,-2.527227076,101.7429542
SUNGAI TENANG,11,273,80,29,382,37,77,94,208,590,-2.578226656,102.0107963
MUARA SIAU,20,616,178,90,884,24,71,119,214,1098,-2.28368941,102.0040265
LEMBAH MASURAI,21,803,210,119,1132,45,81,132,258,1390,-2.396309134,101.9162156
TIANG PUMPUNG,22,148,44,25,217,8,17,25,50,267,-2.30629816,102.2431129
PAMENANG,30,750,185,70,1005,64,131,186,381,1386,-2.128173825,102.5208702
PAMENANG BARAT,31,578,161,57,796,53,84,121,258,1054,-2.074133405,102.4043495
RENAH PAMENANG,32,176,60,20,256,9,23,31,63,319,-2.187684488,102.385214
PAMENANG SELATAN,33,245,70,10,325,16,29,48,93,418,-2.277284625,102.3689938
BANGKO,40,873,295,132,1300,28,73,145,246,1546,-2.092187687,102.3058912
BANGKO BARAT,41,304,110,28,442,4,23,63,90,532,-2.180607197,102.2412585
NALO TANTAN,42,618,179,83,880,38,54,102,194,1074,-2.018568378,102.176856
BATANG MASUMAI,43,342,120,61,523,16,32,64,112,635,-2.077167841,102.1821513
SUNGAI MANAU,50,568,183,65,816,31,69,106,206,1022,-2.078337578,101.9425334
RENAH PEMBARAP,51,599,215,83,897,27,59,101,187,1084,-2.119269918,102.0695839
PANGKALAN JAMBU,52,162,59,30,251,9,23,44,76,327,-2.130433152,101.8421716
TABIR,60,744,180,50,974,37,136,192,365,1339,-1.81180724,102.2648732
TABIR ULU,61,379,124,62,565,20,67,79,166,731,-1.928455323,102.1765529
TABIR SELATAN,62,446,129,56,631,14,53,80,147,778,-1.942664656,102.4227449
TABIR ILIR,63,311,65,18,394,9,45,59,113,507,-1.745899378,102.398036
TABIR TIMUR,64,149,43,23,215,10,21,30,61,276,-1.706229818,102.4833126
TABIR LINTAS,65,127,33,16,176,3,15,24,42,218,-1.931276872,102.293436
MARGO TABIR,66,256,40,19,315,28,38,72,138,453,-1.879463611,102.3746691
TABIR BARAT,67,890,351,194,1435,54,72,161,287,1722,-1.926133743,101.8720151
BATANG ASAI,10,1045,474,218,1737,36,77,189,302,2039,-2.53792948,102.2400683
LIMUN,20,1102,367,206,1675,50,90,177,317,1992,-2.569354976,102.5162386
CERMIN NAN GEDANG,21,1050,403,206,1659,42,71,190,303,1962,-2.395614322,102.5021728
PELAWAN,30,1676,656,336,2668,73,133,319,525,3193,-2.40506959,102.7520587
SINGKUT,31,1645,573,234,2452,79,146,334,559,3011,-2.530895821,102.7020549
SAROLANGUN,40,1722,696,349,2767,61,155,375,591,3358,-2.272964097,102.7135036
BATHIN VIII,41,847,333,192,1372,15,47,135,197,1569,-2.256934608,102.5374922
PAUH,50,1497,420,175,2092,114,250,371,735,2827,-2.213242353,102.8738499
AIR HITAM,51,1534,496,206,2236,122,188,361,671,2907,-2.009543002,102.6486555
MANDIANGIN,60,1271,497,255,2023,89,117,281,487,2510,-2.109986154,103.0521919
MERSAM,10,877,346,187,1410,27,94,228,349,1759,-1.553383504,102.9567896
MARO SEBO ULU,11,1888,648,333,2869,130,222,553,905,3774,-1.745406408,102.7634958
BATIN XXIV,20,650,212,115,977,95,98,178,371,1348,-1.873302502,102.9445943
MUARA TEMBESI,30,1322,482,237,2041,53,123,276,452,2493,-1.704939093,103.1027731
MUARA BULIAN,40,1562,518,353,2433,85,155,303,543,2976,-1.727603205,103.2378991
BAJUBANG,41,793,270,107,1170,48,91,196,335,1505,-2.020303899,103.324953
MARO SEBO ILIR,42,337,130,63,530,17,29,72,118,648,-1.582918982,103.1766589
PEMAYUNG,50,1230,485,243,1958,46,129,237,412,2370,-1.494857466,103.2789637
MESTONG,10,1089,370,138,1597,123,94,235,452,2049,-1.806071815,103.5272916
SUNGAI BAHAR,11,386,149,81,616,8,13,51,72,688,-2.001812035,103.4391
BAHAR SELATAN,12,367,135,73,575,40,14,53,107,682,,
BAHAR UTARA,13,434,167,73,674,20,18,62,100,774,,
KUMPEH ULU,20,1874,720,284,2878,51,127,375,553,3431,-1.594257952,103.7965961
SUNGAI GELAM,21,1093,393,204,1690,60,100,219,379,2069,-1.731413219,103.7838795
KUMPEH,30,1462,560,289,2311,43,80,291,414,2725,-1.538439147,104.053756
MARO SEBO,40,1019,407,212,1638,33,72,201,306,1944,-1.443058749,103.6533067
TAMAN RAJO,41,851,294,171,1316,9,33,142,184,1500,,
JAMBI LUAR KOTA,50,1787,649,321,2757,82,134,338,554,3311,-1.645267992,103.4847104
SEKERNAN,60,1359,522,274,2155,120,145,293,558,2713,-1.380521179,103.4143176
MENDAHARA,10,1135,325,142,1602,87,169,292,548,2150,-1.017666415,103.6099666
MENDAHARA ULU,11,702,206,49,957,45,101,166,312,1269,-1.206686563,103.5164323
GERAGAI,12,497,166,71,734,29,47,100,176,910,-1.23623428,103.6887948
DENDANG,20,501,200,76,777,30,48,121,199,976,-1.245989901,103.9351648
MUARA SABAK BARAT,31,468,176,79,723,29,40,96,165,888,-1.216171275,103.8101757
MUARA SABAK TIMUR,32,892,320,112,1324,124,129,238,491,1815,-1.071413424,103.9437011
KUALA JAMBI,33,419,172,95,686,43,59,92,194,880,-1.048576658,103.7871448
RANTAU RASAU,40,702,269,137,1108,28,53,109,190,1298,-1.162356277,104.0923237
BERBAK,41,572,184,91,847,41,49,89,179,1026,-1.224086609,104.1520341
NIPAH PANJANG,50,546,233,101,880,40,87,136,263,1143,-1.084046786,104.191239
SADU,60,448,139,46,633,68,58,164,290,923,,
TUNGKAL ULU,10,191,52,43,286,7,18,26,51,337,-1.149622887,103.1081232
MERLUNG,11,179,59,31,269,8,17,35,60,329,-1.32260408,103.0242931
BATANG ASAM,12,575,158,81,814,28,63,117,208,1022,-1.079031722,102.8749858
TEBING TINGGI,13,517,204,74,795,30,45,123,198,993,-1.025879989,103.1164316
RENAH MENDALUH,14,469,126,40,635,24,56,123,203,838,-1.28980236,102.85674
MUARA PAPALIK,15,104,16,9,129,5,9,13,27,156,-1.297268566,103.1626773
PENGABUAN,20,1507,542,210,2259,71,180,340,591,2850,-0.886937941,103.2262084
SENYERANG,21,978,340,168,1486,97,134,243,474,1960,-0.844043172,103.0688219
TUNGKAL ILIR,30,2720,908,462,4090,139,307,635,1081,5171,-0.837580538,103.4920149
BRAM ITAM,31,814,289,116,1219,52,91,172,315,1534,-0.973917778,103.3124704
SEBERANG KOTA,32,463,186,63,712,73,93,135,301,1013,-0.794944917,103.3886711
BETARA,40,1285,398,214,1897,56,102,265,423,2320,-1.087586301,103.3740025
KUALA BETARA,41,777,228,91,1096,38,100,222,360,1456,-0.925250844,103.5073861
TEBO ILIR,10,610,191,101,902,42,83,193,318,1220,-1.550837602,102.7314432
MUARA TABIR,11,368,124,52,544,42,71,118,231,775,-1.728436837,102.5788593
TEBO TENGAH,20,1050,335,143,1528,65,178,284,527,2055,-1.425281229,102.5159768
SUMAY,21,1047,352,148,1547,103,157,281,541,2088,-1.176816192,102.4393111
TENGAH ILIR,22,288,95,37,420,50,45,87,182,602,-1.397739743,102.6877289
RIMBO BUJANG,30,1331,412,180,1923,34,119,238,391,2314,-1.330298826,102.1413239
RIMBO ULU,31,503,153,52,708,15,44,99,158,866,-1.287189593,102.0023393
RIMBO ILIR,32,424,127,52,603,11,19,63,93,696,-1.405079611,102.2605598
TEBO ULU,40,1163,364,156,1683,64,118,217,399,2082,-1.27915274,102.265946
VII KOTO,41,880,254,107,1241,30,85,151,266,1507,-1.050498579,101.9754514
SERAI SERUMPUN,42,593,228,92,913,45,67,179,291,1204,-1.179857733,102.2863352
VII KOTO ILIR,43,460,160,80,700,16,53,61,130,830,-1.034648078,102.1372906
PELEPAT,10,975,247,82,1304,79,168,240,487,1791,-1.754860243,102.0327617
PELEPAT ILIR,11,606,207,77,890,40,82,131,253,1143,-1.622755631,102.3436236
BATHIN II BABEKO,21,224,72,35,331,9,26,42,77,408,-1.511912688,102.2337174
RIMBO TENGAH,22,344,127,37,508,15,32,59,106,614,-1.547819325,102.1327081
BUNGO DANI,23,449,209,68,726,12,42,99,153,879,-1.49477797,102.0783172
PASAR MUARA BUNGO,24,350,120,61,531,17,31,57,105,636,-1.49070003,102.1305786
BATHIN III,25,503,165,62,730,31,71,141,243,973,-1.440769285,102.0894159
RANTAU PANDAN,30,449,111,68,628,17,52,92,161,789,-1.648213145,101.9377103
MUKO-MUKO BATHIN VII,31,669,241,98,1008,25,79,145,249,1257,-1.541233668,102.002843
BATHIN III ULU,32,701,251,86,1038,29,62,129,220,1258,-1.715888802,101.8210678
TANAH SEPENGGAL,40,1046,412,149,1607,50,143,312,505,2112,-1.447267429,101.958311
TANAH SEPENGGAL LINTAS,41,972,403,163,1538,30,89,257,376,1914,-1.391166432,101.9530381
TANAH TUMBUH,50,301,148,64,513,23,27,62,112,625,-1.482188058,101.8799882
LIMBUR LUBUK MENGKUANG,51,379,146,50,575,24,47,82,153,728,-1.66001218,101.6442
BATHIN II PELAYANG,52,196,54,5,255,14,42,77,133,388,-1.429923194,101.8006684
JUJUHAN,60,471,186,72,729,15,28,69,112,841,-1.310589409,101.7718274
JUJUHAN ILIR,61,272,96,27,395,2,22,55,79,474,-1.207194919,101.8980086
KOTA BARU,10,3628,1489,821,5938,181,205,579,965,6903,-1.64966442,103.5765459
JAMBI SELATAN,20,3669,1555,873,6097,152,174,625,951,7048,-1.630274982,103.6455838
JELUTUNG,30,1875,832,434,3141,64,90,376,530,3671,-1.616709836,103.6130172
PASAR JAMBI,40,418,166,104,688,21,30,110,161,849,-1.594641928,103.6138073
TELANAIPURA,50,3783,1543,776,6102,119,225,707,1051,7153,-1.595780817,103.5716456
DANAU TELUK,60,657,291,178,1126,41,35,101,177,1303,-1.570177677,103.5932075
PELAYANGAN,70,774,345,207,1326,28,23,184,235,1561,-1.563643707,103.623926
JAMBI TIMUR,80,3398,1459,818,5675,150,186,696,1032,6707,-1.585481564,103.638575
TANAH KAMPUNG,10,302,109,60,471,11,17,49,77,548,-2.077645476,101.43848
KUMUN DEBAI,20,245,103,75,423,19,11,33,63,486,-2.163538409,101.3362473
SUNGAI PENUH,30,473,188,92,753,21,18,76,115,868,-2.085427187,101.3300789
HAMPARAN RAWANG,40,580,206,103,889,9,22,79,110,999,-2.045106345,101.4181328
PESISIR BUKIT,50,638,310,163,1111,50,34,81,165,1276,-2.041502396,101.3682186
LENGKITI,52,1451,538,301,2290,63,123,283,469,2759,-4.324373389,104.0178039
SOSOH BUAY RAYAP,70,551,232,108,891,68,83,149,300,1191,-4.207561998,104.1101914
PENGANDONAN,80,410,162,87,659,16,48,91,155,814,-4.103556765,103.9114118
SEMIDANG AJI,81,765,300,145,1210,65,116,212,393,1603,-4.029322518,103.9859405
ULU OGAN,82,303,123,58,484,50,65,87,202,686,-4.191224561,103.7116667
MUARA JAYA,83,376,177,134,687,26,29,112,167,854,-4.149312435,103.8573099
PENINJAUAN,90,1020,434,231,1685,75,104,251,430,2115,-3.856906172,104.3624581
LUBUK BATANG,91,1253,459,214,1926,97,165,396,658,2584,-3.961577311,104.1670705
SINAR PENINJAUAN,92,342,135,52,529,20,34,84,138,667,-3.936862603,104.4252419
BATU RAJA TIMUR,130,1668,847,530,3045,171,124,300,595,3640,-4.151586183,104.2160627
LUBUK RAJA,131,303,143,59,505,19,28,71,118,623,-4.126291918,104.2910936
BATU RAJA BARAT,140,1095,547,312,1954,49,71,211,331,2285,-4.109344825,104.1197978
LEMPUING,10,1373,446,270,2089,129,151,308,588,2677,-3.903568663,104.9433478
LEMPUING JAYA,11,1896,601,235,2732,142,301,574,1017,3749,-3.692114266,104.915287
MESUJI,20,721,284,204,1209,66,75,93,234,1443,-3.913479251,105.132102
SUNGAI MENANG,21,1401,312,100,1813,77,197,294,568,2381,-3.845286668,105.6271101
MESUJI MAKMUR,22,1060,264,53,1377,59,130,226,415,1792,-4.127805446,104.8972597
MESUJI RAYA,23,891,303,201,1395,80,68,101,249,1644,-3.747688481,105.0970902
TULUNG SELAPAN,30,2320,691,457,3468,156,235,374,765,4233,-3.112411321,105.6540353
CENGAL,31,1614,299,121,2034,300,413,538,1251,3285,-3.518851862,105.6110182
PEDAMARAN,40,2178,851,686,3715,360,414,801,1575,5290,-3.467378874,104.9656347
PEDAMARAN TIMUR,41,518,98,24,640,22,81,122,225,865,-3.546317027,105.1562913
TANJUNG LUBUK,50,2187,794,305,3286,86,200,531,817,4103,-3.573281717,104.7099782
TELUK GELAM,51,900,310,161,1371,73,116,214,403,1774,-3.59056212,104.7882373
KOTA KAYU AGUNG,60,3049,999,450,4498,212,414,720,1346,5844,-3.382433447,104.8613632
SIRAH PULAU PADANG,120,2899,1163,698,4760,303,307,531,1141,5901,-3.291064646,104.8765659
JEJAWI,121,2021,678,358,3057,167,362,578,1107,4164,-3.173692212,104.8561512
PAMPANGAN,130,1911,530,292,2733,142,275,459,876,3609,-3.274359647,105.0183374
PANGKALAN LAPAM,131,986,280,165,1431,117,122,181,420,1851,-3.118817522,105.1534128
AIR SUGIHAN,140,1299,319,119,1737,67,129,218,414,2151,-2.725201869,105.3802368
SEMENDO DARAT LAUT,10,1020,386,219,1625,54,74,226,354,1979,-4.098217957,103.6414577
SEMENDO DARAT ULU,11,1655,680,295,2630,52,92,405,549,3179,-4.273453515,103.5110852
SEMENDO DARAT TENGAH,12,969,446,207,1622,40,101,187,328,1950,-4.182191545,103.4743794
TANJUNG AGUNG,20,2302,822,416,3540,152,247,561,960,4500,-3.934366873,103.7863056
RAMBANG,31,916,293,130,1339,43,79,154,276,1615,-3.609540871,104.1566567
LUBAI,32,1935,618,273,2826,161,223,387,771,3597,-3.740017511,104.2099249
LAWANG KIDUL,40,1517,661,383,2561,36,54,222,312,2873,-3.774650951,103.8316491
MUARA ENIM,50,2106,814,462,3382,54,91,369,514,3896,-3.664996741,103.8060014
UJAN MAS,51,1082,435,250,1767,56,81,206,343,2110,-3.530549358,103.7034881
GUNUNG MEGANG,60,3571,1205,515,5291,169,363,780,1312,6603,-3.518357708,103.8991491
BENAKAT,61,706,225,80,1011,74,131,225,430,1441,-3.404103145,103.734808
RAMBANG DANGKU,70,2220,703,241,3164,79,215,442,736,3900,-3.584826155,104.0278563
TALANG UBI,80,3764,1201,471,5436,346,509,786,1641,7077,-3.283086873,103.8548868
PENUKAL,81,1382,389,149,1920,62,164,252,478,2398,-3.156573955,104.0509709
TANAH ABANG,82,1531,620,278,2429,69,118,303,490,2919,-3.311305379,104.1374496
PENUKAL UTARA,83,1686,472,166,2324,61,152,245,458,2782,-3.091996107,103.9528017
ABAB,84,1144,274,108,1526,69,183,202,454,1980,-3.171182041,104.1651683
GELUMBANG,90,1824,588,298,2710,76,154,333,563,3273,-3.219953748,104.4131326
LEMBAK,91,898,189,78,1165,50,158,190,398,1563,-3.404829303,104.3507312
SUNGAI ROTAN,92,2241,689,257,3187,190,338,640,1168,4355,-3.151573706,104.2907102
MUARA BELIDA,93,627,166,62,855,107,160,293,560,1415,-3.069339107,104.5120546
KELEKAR,94,638,171,90,899,25,42,108,175,1074,-3.342248703,104.4780447
TANJUNG SAKTI PUMI,11,989,437,257,1683,29,43,148,220,1903,-4.154637058,103.1135916
TANJUNG SAKTI PUMU,12,789,342,136,1267,29,48,143,220,1487,-4.081977562,103.0124151
KOTA AGUNG,40,778,355,199,1332,34,57,156,247,1579,-4.124807336,103.4079946
MULAK ULU,41,1156,480,213,1849,28,46,158,232,2081,-4.032517259,103.5276164
TANJUNG TEBAT,42,582,236,95,913,16,31,90,137,1050,-3.986002688,103.4536574
PULAU PINANG,50,811,311,132,1254,24,53,128,205,1459,-3.858354052,103.5599864
PAGAR GUNUNG,51,469,182,85,736,33,40,72,145,881,-3.937851465,103.5749472
GUMAY ULU,52,220,80,31,331,8,32,62,102,433,-3.928236159,103.4034444
JARAI,60,958,394,185,1537,18,53,178,249,1786,-3.937041504,103.1776834
PAJAR BULAN,61,853,353,149,1355,50,55,149,254,1609,-3.96182209,103.2862269
MUARA PAYANG,62,448,169,66,683,21,29,64,114,797,-3.895248531,103.1359705
KIKIM BARAT,111,813,267,140,1220,50,74,135,259,1479,-3.571695578,103.2080811
KIKIM TIMUR,112,1144,446,211,1801,79,109,209,397,2198,-3.629283593,103.3831043
KIKIM SELATAN,113,1187,450,192,1829,81,116,259,456,2285,-3.759341536,103.2024201
KIKIM TENGAH,114,443,173,62,678,17,47,86,150,828,-3.652575384,103.2518394
LAHAT,120,2913,1253,580,4746,103,189,508,800,5546,-3.727731771,103.5439567
GUMAY TALANG,121,498,180,83,761,46,68,102,216,977,-3.780514048,103.4589181
PSEKSU,122,672,272,75,1019,35,53,139,227,1246,-3.821484465,103.3195441
MERAPI BARAT,131,1195,505,228,1928,46,83,226,355,2283,-3.755711852,103.6476982
MERAPI TIMUR,132,722,301,161,1184,49,62,150,261,1445,-3.631291071,103.6626108
MERAPI SELATAN,133,602,266,134,1002,10,22,106,138,1140,-3.866553729,103.6594946
RAWAS ULU,10,764,301,147,1212,144,195,276,615,1827,-2.626668809,102.7518396
ULU RAWAS,11,623,231,137,991,50,73,141,264,1255,-2.815818117,102.3285355
RUPIT,20,1689,712,410,2811,70,134,419,623,3434,-2.744838411,102.8273714
KARANG JAYA,21,1734,513,255,2502,110,268,548,926,3428,-2.921087248,102.6252197
SUKU TENGAH LAKITAN ULU,30,1099,414,156,1669,131,157,334,622,2291,-3.07684054,102.7359748
SELANGIT,31,1304,431,298,2033,112,173,355,640,2673,-3.214910048,102.6740452
SUMBER HARTA,32,628,198,129,955,22,61,124,207,1162,-3.031128874,102.9499393
TUGU MULYO,40,1277,513,249,2039,59,111,315,485,2524,-3.173342286,102.9620983
PURWODADI,41,220,99,49,368,14,33,60,107,475,-3.105160905,102.9880637
MUARA BELITI,50,646,286,158,1090,224,156,204,584,1674,-3.257061453,103.0135463
TIANG PUMPUNG KEPUNGUT,51,521,234,125,880,22,30,112,164,1044,-3.363716651,103.0826662
JAYA LOKA,60,561,184,91,836,73,70,152,295,1131,-3.347291089,103.1960351
SUKA KARYA,61,476,179,54,709,15,48,132,195,904,-3.232317178,103.1878243
MUARA KELINGI,70,1676,677,316,2669,44,163,392,599,3268,-3.047800803,103.2450135
BULAN TENGAH SUKU ULU,71,924,274,152,1350,145,175,228,548,1898,-3.348813045,103.3131668
TUAH NEGERI,72,716,233,123,1072,49,85,192,326,1398,-3.154437991,103.1010202
MUARA LAKITAN,80,1424,514,281,2219,102,186,351,639,2858,-3.144829249,103.4190793
MEGANG SAKTI,90,1535,567,227,2329,73,187,469,729,3058,-2.967551328,103.0207886
RAWAS ILIR,100,1210,400,165,1775,48,142,339,529,2304,-2.619268518,103.174571
KARANG DAPO,101,600,294,147,1041,36,53,136,225,1266,-2.751054247,102.9905336
NIBUNG,102,1063,349,160,1572,91,148,270,509,2081,-2.453522752,102.947323
SANGA DESA,10,1360,580,355,2295,205,167,351,723,3018,-2.712322522,103.4177855
BABAT TOMAN,20,1114,470,260,1844,41,69,205,315,2159,-2.767707913,103.6466389
BATANGHARI LEKO,21,752,225,117,1094,256,168,191,615,1709,-2.453073694,103.4432197
PLAKAT TINGGI,22,1061,398,229,1688,43,47,155,245,1933,-2.924059452,103.549293
LAWANG WETAN,23,1363,619,431,2413,180,90,190,460,2873,,
SUNGAI KERUH,30,1889,588,271,2748,476,284,398,1158,3906,-3.098770803,103.6936255
SEKAYU,40,2552,1087,634,4273,205,177,408,790,5063,-2.870027549,103.8552906
LAIS,41,2754,965,468,4187,206,375,644,1225,5412,-2.916988921,104.0478524
SUNGAI LILIN,90,1548,547,295,2390,132,125,267,524,2914,-2.644876871,104.0829637
KELUANG,91,826,288,146,1260,41,83,143,267,1527,-2.583760599,103.9243004
BABAT SUPAT,92,753,275,172,1200,146,112,204,462,1662,,
BAYUNG LENCIR,100,2993,822,336,4151,528,578,720,1826,5977,-2.11299861,103.9023789
LALAN,101,1880,726,509,3115,375,282,394,1051,4166,-2.351530218,104.3632197
TUNGKAL JAYA,102,1622,634,385,2641,153,99,244,496,3137,,
RANTAU BAYUR,10,1582,532,231,2345,382,366,502,1250,3595,-3.009786566,104.3829495
BETUNG,20,1891,615,262,2768,114,232,491,837,3605,-2.796000704,104.2813824
PULAU RIMAU,30,1956,692,258,2906,223,251,589,1063,3969,-2.557262298,104.4639707
TUNGKAL ILIR,31,804,266,108,1178,129,160,194,483,1661,-2.540160232,104.2205075
BANYUASIN III,40,1836,609,260,2705,238,308,521,1067,3772,-2.888955511,104.4419309
TALANG KELAPA,50,3005,1145,687,4837,418,317,580,1315,6152,-2.815566919,104.6928368
TANJUNG LAGO,51,2074,484,172,2730,238,508,717,1463,4193,-2.639300189,104.6321459
BANYUASIN I,60,4287,1527,656,6470,587,724,1340,2651,9121,-2.865946284,104.9554856
RAMBUTAN,70,1844,535,245,2624,145,382,567,1094,3718,-3.051326349,104.9316343
MUARA PADANG,80,1283,496,245,2024,264,183,355,802,2826,-2.646999603,105.1175507
MUARA SUGIHAN,81,1577,531,171,2279,122,224,393,739,3018,-2.44959802,105.2464889
MAKARTI JAYA,90,1877,561,160,2598,136,306,537,979,3577,-2.540522875,104.9594705
AIR SALEK,91,1413,492,157,2062,78,189,322,589,2651,-2.604630156,105.0221497
BANYUASIN II,100,2116,622,291,3029,484,439,661,1584,4613,-2.062915655,104.5750831
MUARA TELANG,110,3283,1068,460,4811,446,564,1100,2110,6921,-2.581241537,104.8223891
MEKAKAU ILIR,10,1048,307,156,1511,91,101,185,377,1888,-4.660575544,103.7748461
BANDING AGUNG,20,982,307,173,1462,36,54,140,230,1692,-4.766538678,103.91334
WARKUK RANAU SELATAN,21,792,236,107,1135,41,52,113,206,1341,-4.858171593,104.1136346
BUAY PEMATANG RIBU RANAU TENGAH,22,751,243,111,1105,28,75,131,234,1339,-4.780263876,104.0537327
BUAY PEMACA,30,1443,339,99,1881,97,194,299,590,2471,-4.721910127,104.2292287
SIMPANG,40,913,272,140,1325,54,109,212,375,1700,-4.453050518,104.174925
BUANA PEMACA,41,1028,351,163,1542,60,130,225,415,1957,-4.55566162,104.2203605
MUARADUA,50,1249,357,180,1786,81,164,259,504,2290,-4.537000603,104.0507368
BUAY RAWAN,51,635,172,81,888,44,72,154,270,1158,-4.641753126,104.047391
BUAY SANDANG AJI,60,899,249,106,1254,82,94,197,373,1627,-4.542072931,103.8760977
TIGA DIHAJI,61,571,139,58,768,16,33,87,136,904,-4.623523431,103.9235058
BUAY RUNJUNG,70,572,197,95,864,8,39,112,159,1023,-4.486578636,103.9002594
RUNJUNG AGUNG,71,272,78,45,395,27,55,42,124,519,-4.424549267,103.8866442
KISAM TINGGI,80,688,190,83,961,15,40,82,137,1098,-4.315380625,103.7675232
MUARADUA KISAM,90,664,195,88,947,6,18,79,103,1050,-4.390396799,103.7041032
KISAM ILIR,91,345,80,31,456,22,34,63,119,575,-4.47723443,103.7788555
PULAU BERINGIN,100,1720,605,252,2577,70,127,277,474,3051,-4.501621117,103.6654782
SINDANG DANAU,101,963,306,175,1444,51,51,140,242,1686,-4.449881013,103.5444881
SUNGAI ARE,102,729,174,85,988,36,86,118,240,1228,-4.475998119,103.4655116
MARTAPURA,10,1583,587,234,2404,63,157,379,599,3003,-4.30293031,104.3300956
BUNGA MAYANG,11,707,212,57,976,48,99,190,337,1313,-4.378754387,104.2407971
JAYA PURA,12,803,296,96,1195,38,85,199,322,1517,-4.465957748,104.2933263
BUAY PEMUKA PELIUNG,20,1268,510,192,1970,37,81,244,362,2332,-4.2437569,104.3918078
BUAY MADANG,30,1063,464,195,1722,42,75,232,349,2071,-4.245584302,104.4981611
BUAY MADANG TIMUR,31,1096,425,149,1670,98,117,278,493,2163,-4.172044468,104.5662481
BUAY PEMUKA BANGSA RAJA,32,673,218,66,957,47,109,242,398,1355,-4.160735072,104.4691278
MADANG SUKU II,40,1136,414,108,1658,65,89,228,382,2040,-4.071464251,104.499733
MADANG SUKU III,41,928,288,87,1303,30,85,186,301,1604,-4.09491116,104.3820555
MADANG SUKU I,50,2018,630,176,2824,117,309,581,1007,3831,-3.965612109,104.5462779
BELITANG MADANG RAYA,51,957,287,94,1338,53,123,225,401,1739,-4.058411481,104.6117829
BELITANG,60,889,358,112,1359,25,61,163,249,1608,-4.153230335,104.6388548
BELITANG JAYA,61,573,189,42,804,21,78,164,263,1067,-4.210301685,104.6866356
BELITANG III,70,778,266,73,1117,39,121,218,378,1495,-4.132160986,104.7346367
BELITANG II,80,743,219,60,1022,40,98,198,336,1358,-4.025382239,104.8278752
BELITANG MULYA,81,479,192,58,729,61,58,138,257,986,-4.038410296,104.7322064
SEMENDAWAI SUKU III,90,1064,363,118,1545,61,84,217,362,1907,-3.967017501,104.6985652
SEMENDAWAI TIMUR,91,672,193,80,945,97,148,226,471,1416,-3.890662934,104.8310724
CEMPAKA,100,1030,487,161,1678,18,52,273,343,2021,-3.75240095,104.7133738
SEMENDAWAI BARAT,101,1191,516,258,1965,25,72,194,291,2256,-3.859495297,104.6592203
MUARA KUANG,10,767,301,184,1252,63,91,151,305,1557,-3.667659884,104.5772744
RAMBANG KUANG,11,383,103,29,515,36,55,81,172,687,-3.613679577,104.4444555
LUBUK KELIAT,12,758,251,99,1108,74,109,242,425,1533,-3.48846095,104.622706
TANJUNG BATU,20,787,264,100,1151,54,109,161,324,1475,-3.340554167,104.622179
PAYARAMAN,21,591,232,79,902,24,51,94,169,1071,-3.435088606,104.5236536
RANTAU ALAI,30,618,219,104,941,65,100,159,324,1265,-3.441819604,104.7333708
KANDIS,31,621,224,123,968,51,98,188,337,1305,-3.426495097,104.7925616
TANJUNG RAJA,40,1639,626,337,2602,68,154,347,569,3171,-3.343803274,104.7435983
RANTAU PANJANG,41,1329,388,153,1870,99,272,452,823,2693,-3.285869472,104.7685759
SUNGAI PINANG,42,1463,375,139,1977,87,378,576,1041,3018,-3.35843104,104.7949221
PEMULUTAN,50,2540,839,327,3706,200,421,797,1418,5124,-3.108938738,104.764675
PEMULUTAN SELATAN,51,1065,370,183,1618,110,193,319,622,2240,-3.223769013,104.7817443
PEMULUTAN BARAT,52,703,241,174,1118,159,118,238,515,1633,-3.176187029,104.7290526
INDRALAYA,60,1218,418,168,1804,77,203,388,668,2472,-3.24783538,104.6856955
INDRALAYA UTARA,61,605,174,52,831,36,110,191,337,1168,-3.154253792,104.6024439
INDRALAYA SELATAN,62,819,283,134,1236,39,107,184,330,1566,-3.301926176,104.6865775
MUARA PINANG,10,1400,581,277,2258,73,131,289,493,2751,-3.860511329,103.0899771
LINTANG KANAN,20,1349,556,359,2264,68,127,316,511,2775,-3.93866816,103.0189107
PENDOPO,30,1689,704,365,2758,70,172,404,646,3404,-3.818543648,102.9570354
PASMA AIR KERUH,40,850,240,113,1203,86,96,183,365,1568,-3.870045773,102.7669747
ULU MUSI,50,828,334,160,1322,27,48,181,256,1578,-3.750948694,102.8208162
SIKAP DALAM,51,677,230,124,1031,25,45,129,199,1230,,
TALANG PADANG,60,495,192,133,820,45,67,109,221,1041,-3.68339313,102.9334055
TEBING TINGGI,70,2464,799,412,3675,128,329,619,1076,4751,-3.60323628,103.0560846
ILIR BARAT II,10,3079,1253,624,4956,120,246,671,1037,5993,-2.998204672,104.7450105
GANDUS,11,3119,1299,706,5124,221,241,622,1084,6208,-3.003643425,104.6705944
SEBERANG ULU I,20,8422,3294,1888,13604,724,768,1929,3421,17025,-3.012590754,104.7724888
KERTAPATI,21,5838,2409,1320,9567,501,644,1496,2641,12208,-3.042370686,104.719022
SEBERANG ULU II,30,4021,1753,961,6735,277,384,1040,1701,8436,-2.997319897,104.7901048
PLAJU,31,3062,1432,893,5387,132,136,587,855,6242,-3.009761993,104.8122896
ILIR BARAT I,40,3290,1330,727,5347,183,197,622,1002,6349,-2.967166299,104.6844719
BUKIT KECIL,41,1298,522,274,2094,54,90,244,388,2482,-2.987583589,104.7522621
ILIR TIMUR I,50,1756,753,399,2908,57,89,313,459,3367,-2.973221105,104.7503816
KEMUNING,51,2358,926,584,3868,62,100,395,557,4425,-2.954507985,104.7503192
ILIR TIMUR II,60,4067,1735,936,6738,178,279,858,1315,8053,-2.965286649,104.7784005
KALIDONI,61,2659,1235,834,4728,173,138,473,784,5512,-2.964153896,104.8205
SAKO,70,2121,870,481,3472,118,130,361,609,4081,-2.922331835,104.7822096
SEMATANG BORANG,71,1132,480,257,1869,115,93,215,423,2292,-2.943227121,104.8245276
SUKARAMI,80,3050,1190,605,4845,215,236,713,1164,6009,-2.903257314,104.713003
ALANG ALANG LEBAR,81,1565,612,343,2520,64,105,302,471,2991,-2.941713258,104.6994278
RAMBANG KAPAK TENGAH,10,596,200,110,906,32,53,104,189,1095,-3.519216884,104.2266078
PRABUMULIH TIMUR,20,1691,640,305,2636,101,173,414,688,3324,-3.425969876,104.2803004
PRABUMULIH SELATAN,21,622,223,107,952,36,61,126,223,1175,-3.4892391,104.2414474
PRABUMULIH BARAT,30,1296,461,201,1958,110,155,298,563,2521,-3.418753844,104.1738848
PRABUMULIH UTARA,31,1295,509,263,2067,64,96,285,445,2512,-3.416575637,104.2163541
CAMBAI,40,602,159,54,815,63,117,164,344,1159,-3.380639142,104.2684145
DEMPO SELATAN,10,638,233,129,1000,13,46,139,198,1198,-4.12380166,103.330418
DEMPO TENGAH,11,703,274,135,1112,17,45,118,180,1292,-4.145309679,103.2491051
DEMPO UTARA,20,764,318,118,1200,11,39,129,179,1379,-4.089300377,103.1994956
PAGAR ALAM SELATAN,30,1102,438,178,1718,25,70,239,334,2052,-4.035783868,103.1944248
PAGAR ALAM UTARA,40,1366,563,267,2196,14,65,213,292,2488,-4.010079002,103.2120115
LUBUK LINGGAU BARAT I,11,1347,542,231,2120,42,106,254,402,2522,-3.307670749,102.8305383
LUBUK LINGGAU BARAT II,12,917,374,171,1462,46,99,208,353,1815,-3.285187059,102.8452077
LUBUK LINGGAU SELATAN I,21,768,275,111,1154,36,97,173,306,1460,-3.325098385,102.9326207
LUBUK LINGGAU SELATAN II,22,563,221,99,883,23,38,102,163,1046,-3.244860632,102.9246416
LUBUK LINGGAU TIMUR I,31,495,223,96,814,50,35,99,184,998,-3.287939421,102.9004286
LUBUK LINGGAU TIMUR II,32,1350,507,202,2059,33,80,320,433,2492,-3.308927391,102.8807375
LUBUK LINGGAU UTARA I,41,414,110,47,571,62,89,135,286,857,-3.205467231,102.8541264
LUBUK LINGGAU UTARA II,42,1176,474,236,1886,31,105,240,376,2262,-3.257970597,102.8772814
MANNA,40,944,358,260,1562,17,48,126,191,1753,-4.462910708,102.9478707
KOTA MANNA,41,573,257,167,997,12,22,69,103,1100,-4.436482668,102.911381
KEDURANG,42,837,363,215,1415,18,42,95,155,1570,-4.372313509,103.1582141
BUNGA MAS,43,388,162,113,663,5,9,52,66,729,-4.493569729,102.9922291
PASAR MANNA,44,366,150,116,632,12,19,49,80,712,-4.467881141,102.9154313
KEDURANG ILIR,45,448,204,110,762,11,19,78,108,870,-4.513413579,103.0573732
SEGINIM,50,973,431,303,1707,26,43,175,244,1951,-4.441845406,103.0173468
AIR NIPIS,51,858,428,220,1506,16,36,138,190,1696,-4.332166854,103.1022241
PINO,60,707,282,184,1173,13,39,111,163,1336,-4.389725793,102.9695215
PINORAYA,61,1142,453,264,1859,37,82,219,338,2197,-4.293727624,102.9073212
ULU MANNA,62,635,252,118,1005,28,52,129,209,1214,-4.277913155,103.0097442
KOTA PADANG,20,873,265,143,1281,111,120,211,442,1723,-3.475281468,102.9494474
SINDANG BELITI ILIR,21,717,227,98,1042,52,80,181,313,1355,-3.45969835,102.8866077
PADANG ULAK TANDING,30,1517,520,204,2241,116,232,329,677,2918,-3.361337122,102.7517741
SINDANG KELINGI,31,565,204,61,830,32,59,114,205,1035,-3.46450146,102.677573
BINDU RIANG,32,524,178,117,819,9,45,92,146,965,-3.438756954,102.7528635
SINDANG BELITI ULU,33,713,197,75,985,55,96,135,286,1271,-3.473572861,102.8030848
SINDANG DATARAN,34,526,171,56,753,15,38,126,179,932,-3.527357066,102.7245541
CURUP,40,678,268,145,1091,33,42,118,193,1284,-3.472835248,102.5184863
BERMANI ULU,41,760,268,108,1136,48,84,186,318,1454,-3.432890157,102.4388576
SELUPU REJANG,42,1101,354,133,1588,42,131,231,404,1992,-3.429111347,102.6016853
CURUP SELATAN,43,445,190,75,710,62,88,109,259,969,-3.5039959,102.4797778
CURUP TENGAH,44,829,331,159,1319,17,45,125,187,1506,-3.482842,102.5477815
BERMANI ULU RAYA,45,613,255,91,959,17,68,141,226,1185,-3.352685222,102.5002537
CURUP UTARA,46,673,246,124,1043,32,90,145,267,1310,-3.443811941,102.5134362
CURUP TIMUR,47,633,269,88,990,19,54,89,162,1152,-3.457481746,102.5497777
ENGGANO,10,213,59,27,299,8,20,40,68,367,-5.355528123,102.2605431
KERKAP,50,970,364,195,1529,77,92,194,363,1892,-3.478880474,102.3208846
AIR NAPAL,51,802,322,205,1329,50,82,175,307,1636,-3.582346924,102.1734773
AIR BESI,52,654,279,135,1068,72,48,174,294,1362,-3.522151495,102.1647079
HULU PALIK,53,713,295,188,1196,90,71,180,341,1537,,
ARGA MAKMUR,60,1934,693,340,2967,125,178,387,690,3657,-3.417597055,102.2178542
LAIS,70,673,232,95,1000,35,49,130,214,1214,-3.462627793,102.0716085
BATIK NAU,71,558,190,86,834,24,38,124,186,1020,-3.385188306,102.00037
GIRI MULYA,72,416,172,69,657,26,29,66,121,778,-3.235675654,102.0857096
AIR PADANG,73,384,126,66,576,40,46,95,181,757,,
PADANG JAYA,80,1386,463,216,2065,77,133,300,510,2575,-3.305464259,102.1760454
KETAHUN,90,1186,327,128,1641,69,135,227,431,2072,-3.30612953,101.8530297
NAPAL PUTIH,91,1257,428,196,1881,147,164,315,626,2507,-3.110425835,101.9721991
PUTRI HIJAU,100,1040,468,247,1755,86,98,245,429,2184,,
NASAL,10,954,356,132,1442,47,110,250,407,1849,-4.768882243,103.6229906
MAJE,20,734,306,152,1192,40,64,147,251,1443,-4.70330783,103.5115193
KAUR SELATAN,30,430,169,100,699,20,14,55,89,788,-4.732067942,103.4002177
TETAP,31,321,113,52,486,14,18,57,89,575,-4.707124342,103.3755377
KAUR TENGAH,40,184,78,40,302,1,6,9,16,318,-4.710584757,103.3031862
LUAS,41,368,157,74,599,17,23,40,80,679,-4.644427295,103.3600589
MUARA SAHUNG,42,420,177,61,658,10,27,72,109,767,-4.492869471,103.4009827
KINAL,50,325,126,97,548,19,13,44,76,624,-4.526300986,103.3045866
SEMIDANG GUMAY,51,278,135,90,503,5,13,45,63,566,-4.659004369,103.2533663
TANJUNG KEMUNING,60,586,251,142,979,17,32,104,153,1132,-4.595771926,103.1780603
KELAM TENGAH,61,402,133,102,637,10,10,58,78,715,-4.56343072,103.2106794
KAUR UTARA,70,382,152,91,625,11,16,63,90,715,-4.477618272,103.2067034
PADANG GUCI HILIR,71,308,123,63,494,7,8,44,59,553,-4.505696282,103.1507325
LUNGKANG KULE,72,286,111,58,455,22,12,50,84,539,-4.557135143,103.2492878
PADANG GUCI HULU,73,473,169,58,700,14,39,101,154,854,-4.370110526,103.2854407
SEMIDANG ALAS MARAS,10,1375,554,215,2144,51,96,267,414,2558,-4.299793959,102.7903023
SEMIDANG ALAS,20,1070,404,160,1634,20,64,243,327,1961,-4.130232674,102.8694291
TALO,30,614,222,120,956,18,42,122,182,1138,-4.153515715,102.6745326
ILIR TALO,31,832,307,105,1244,16,67,192,275,1519,-4.20774309,102.6365282
TALO KECIL,32,600,219,104,923,38,33,101,172,1095,-4.212905981,102.7387437
ULU TALO,33,394,138,22,554,6,39,80,125,679,-4.038450515,102.755311
SELUMA,40,234,88,44,366,6,11,34,51,417,-4.06756671,102.5648036
SELUMA SELATAN,41,552,192,72,816,29,68,143,240,1056,-4.113198363,102.5339293
SELUMA BARAT,42,314,86,30,430,12,22,76,110,540,-4.050513906,102.4994266
SELUMA TIMUR,43,507,179,60,746,12,47,114,173,919,-4.108859236,102.606449
SELUMA UTARA,44,784,263,124,1171,40,71,206,317,1488,-3.949717694,102.6483434
SUKARAJA,50,890,319,107,1316,43,117,205,365,1681,-3.916001484,102.4035713
AIR PERIUKAN,51,582,205,93,880,33,75,160,268,1148,-4.000850299,102.4201492
LUBUK SANDI,52,714,298,39,1051,4,35,144,183,1234,-3.910389653,102.5416895
IPUH,10,663,270,120,1053,18,36,105,159,1212,-2.995148803,101.5031475
AIR RAMI,11,449,146,49,644,17,41,90,148,792,,
MALIN DEMAN,12,436,169,79,684,5,24,68,97,781,-2.849339584,101.7117448
PONDOK SUGUH,20,342,106,47,495,19,41,73,133,628,-2.729290208,101.5307119
SUNGAI RUMBAI,21,290,132,51,473,6,27,56,89,562,-2.803504021,101.5881062
TERAMANG JAYA,22,395,140,67,602,22,32,59,113,715,-2.676878811,101.446866
TERAS TERUNJAM,30,234,49,25,308,7,20,39,66,374,-2.568743881,101.243842
PENARIK,31,530,163,61,754,43,83,127,253,1007,-2.592338607,101.4189039
SELAGAN RAYA,32,507,171,78,756,23,63,131,217,973,-2.484327129,101.4035036
KOTA MUKOMUKO,40,337,153,68,558,10,21,48,79,637,-2.569310121,101.1443364
AIR DIKIT,41,193,78,47,318,2,7,22,31,349,-2.647908654,101.2496157
XIV KOTO,42,549,219,100,868,41,55,105,201,1069,-2.478848863,101.0817596
LUBUK PINANG,50,508,187,73,768,17,41,89,147,915,-2.421173132,101.1529577
AIR MANJUNTO,51,366,127,55,548,15,27,74,116,664,-2.491621852,101.16703
V KOTO,52,430,145,102,677,15,27,60,102,779,-2.40143505,101.2890004
RIMBO PENGADANG,10,249,96,28,373,11,19,32,62,435,-3.299973571,102.4283831
TOPOS,11,359,122,66,547,7,14,48,69,616,-3.15012005,102.4043761
LEBONG SELATAN,20,877,340,172,1389,26,70,121,217,1606,-3.283786715,102.3288735
BINGIN KUNING,21,351,135,73,559,31,49,91,171,730,-3.173987709,102.2842275
LEBONG TENGAH,30,523,165,81,769,29,54,113,196,965,-3.208232181,102.2336213
LEBONG SAKTI,31,353,139,70,562,45,45,93,183,745,-3.117967302,102.2803712
LEBONG ATAS,40,243,87,35,365,9,7,50,66,431,-3.175600582,102.1767961
PADANG BANO,41,226,75,27,328,15,17,44,76,404,-3.207244316,102.1563088
PELABAI,42,364,103,60,527,15,31,62,108,635,-3.141555623,102.1565706
LEBONG UTARA,50,599,235,107,941,28,42,149,219,1160,-3.108927798,102.1818762
AMEN,51,214,87,44,345,9,20,48,77,422,-3.126398585,102.2142299
URAM JAYA,52,119,54,29,202,8,10,24,42,244,-3.071265903,102.2525367
PINANG BELAPIS,53,296,103,40,439,11,28,64,103,542,-2.910103512,102.0975246
MUARA KEMUMU,10,626,234,76,936,30,52,160,242,1178,-3.598076583,102.7398349
BERMANI ILIR,20,638,258,119,1015,31,44,134,209,1224,-3.692085196,102.7008711
SEBERANG MUSI,30,395,117,41,553,17,22,62,101,654,-3.733669597,102.6268597
TEBAT KARAI,40,595,250,83,928,18,44,126,188,1116,-3.650583782,102.6416596
KEPAHIANG,50,1286,485,198,1969,51,106,230,387,2356,-3.638564845,102.5658124
KABA WETAN,60,471,142,44,657,17,54,109,180,837,-3.57373856,102.6170795
UJAN MAS,70,951,324,120,1395,76,157,194,427,1822,-3.549318901,102.5304354
MERIGI,80,414,163,66,643,25,49,105,179,822,-3.507336144,102.5247489
TALANG EMPAT,10,303,87,33,423,7,38,59,104,527,-3.80875198,102.3812817
KARANG TINGGI,20,297,112,35,444,18,17,61,96,540,-3.774943256,102.452024
TABA PENANJUNG,30,499,135,56,690,92,99,158,349,1039,,
MERIGI KELINDANG,31,182,53,13,248,65,38,52,155,403,-3.600339678,102.4666989
PAGAR JATI,40,358,109,54,521,23,35,59,117,638,-3.5939799,102.3925745
MERIGI SAKTI,41,296,110,63,469,58,30,63,151,620,-3.625600362,102.4193031
PONDOK KELAPA,50,744,195,79,1018,85,134,201,420,1438,-3.676254174,102.2697536
PONDOK KUBANG,51,270,85,43,398,39,24,71,134,532,-3.700276277,102.3524403
PEMATANG TIGA,60,237,84,30,351,51,38,56,145,496,-3.572702102,102.3093539
BANG HAJI,61,179,54,24,257,20,23,33,76,333,-3.603028158,102.3297302
SELEBAR,10,2037,980,635,3652,78,91,305,474,4126,-3.849304207,102.3471375
KAMPUNG MELAYU,11,1425,581,344,2350,114,126,269,509,2859,-3.899340659,102.3054094
GADING CEMPAKA,20,558,288,186,1032,12,20,77,109,1141,-3.819224731,102.3025849
RATU AGUNG,21,1359,665,418,2442,34,61,208,303,2745,-3.807173746,102.2792039
RATU SAMBAN,22,724,319,202,1245,22,35,95,152,1397,-3.800727599,102.2652205
SINGARAN PATI,23,1335,568,379,2282,42,73,221,336,2618,,
TELUK SEGARA,30,889,429,219,1537,24,44,143,211,1748,-3.790097828,102.2561993
SUNGAI SERUT,31,772,387,209,1368,19,30,111,160,1528,-3.789332312,102.3152651
MUARA BANGKA HULU,40,1256,579,350,2185,49,76,239,364,2549,-3.756338377,102.2948446
PESISIR SELATAN,10,1509,684,363,2556,86,158,358,602,3158,,
BENGKUNAT,11,641,190,131,962,25,61,122,208,1170,,
BENGKUNAT BELIMBING,12,2523,875,345,3743,60,248,541,849,4592,,
NGAMBUR,13,1576,563,242,2381,86,232,479,797,3178,-5.427244986,104.1579459
PESISIR TENGAH,20,605,258,133,996,26,19,87,132,1128,-5.181231116,103.9666623
KARYA PENGGAWA,21,796,360,216,1372,22,57,185,264,1636,,
WAY KRUI,22,498,236,122,856,13,25,73,111,967,,
KRUI SELATAN,23,691,294,167,1152,31,53,161,245,1397,,
PESISIR UTARA,30,717,310,192,1219,26,35,111,172,1391,-5.018467643,103.8377193
LEMONG,31,883,319,182,1384,14,53,163,230,1614,-4.89596061,103.7436441
BALIK BUKIT,40,1681,663,323,2667,84,127,326,537,3204,-5.019814559,104.070955
SUKAU,41,1518,599,294,2411,70,145,401,616,3027,-4.941660193,103.9857222
LUMBOK SEMINUNG,42,456,157,50,663,26,47,104,177,840,,
BELALAU,50,892,286,146,1324,23,50,120,193,1517,-4.984165103,104.2263485
SEKINCAU,51,819,289,108,1216,37,90,198,325,1541,-4.963594345,104.3400006
SUOH,52,861,288,115,1264,41,105,247,393,1657,-5.230432111,104.3220851
BATU BRAK,53,660,257,132,1049,29,44,132,205,1254,-5.112625228,104.1665621
PAGAR DEWA,54,505,156,65,726,29,52,126,207,933,,
BATU KETULIS,55,1066,282,129,1477,48,135,198,381,1858,,
BANDAR NEGERI SUOH,56,1699,596,167,2462,79,196,520,795,3257,,
SUMBER JAYA,60,941,313,103,1357,33,123,212,368,1725,-5.020397944,104.4941171
WAY TENONG,61,981,354,171,1506,43,96,214,353,1859,-5.068794589,104.3883535
GEDUNG SURIAN,62,729,252,92,1073,39,89,197,325,1398,-5.112725966,104.4657054
KEBUN TEBU,63,767,288,100,1155,43,93,171,307,1462,,
AIR HITAM,64,506,222,64,792,36,81,147,264,1056,,
WONOSOBO,10,2322,1070,454,3846,63,183,608,854,4700,-5.472264676,104.5355394
SEMAKA,11,2068,838,254,3160,56,222,666,944,4104,-5.489904318,104.4655053
BANDAR NEGERI SEMUONG,12,963,344,140,1447,37,127,307,471,1918,-5.427583898,104.4771801
KOTA AGUNG,20,2610,881,380,3871,157,349,805,1311,5182,-5.466363097,104.6367349
PEMATANG SAWA,21,1033,370,191,1594,40,143,260,443,2037,-5.769782536,104.6343518
KOTA AGUNG TIMUR,22,1083,418,156,1657,64,130,303,497,2154,-5.492793047,104.7055782
KOTA AGUNG BARAT,23,1501,580,243,2324,138,230,527,895,3219,-5.469405432,104.5820511
PULAU PANGGUNG,30,1964,737,243,2944,51,242,557,850,3794,-5.328608273,104.6960284
ULUBELU,31,1354,520,164,2038,73,221,424,718,2756,,
AIR NANINGAN,32,1329,413,105,1847,109,245,469,823,2670,-5.250625521,104.7151056
TALANG PADANG,40,2748,1105,474,4327,111,328,804,1243,5570,-5.366430054,104.7747796
SUMBEREJO,41,954,381,101,1436,31,90,220,341,1777,-5.378076616,104.7060598
GISTING,42,1093,492,162,1747,40,119,275,434,2181,-5.435293251,104.7363922
GUNUNG ALIP,43,1241,488,172,1901,64,189,430,683,2584,-5.403738781,104.7719879
PUGUNG,50,3680,1216,403,5299,243,664,1244,2151,7450,-5.416834923,104.8225803
BULOK,101,1389,474,123,1986,91,211,498,800,2786,-5.479099487,104.8765578
CUKUH BALAK,110,1700,750,355,2805,41,130,376,547,3352,-5.658662289,104.8966146
KELUMBAYAN,111,1158,463,171,1792,60,92,288,440,2232,-5.723508146,105.0464856
LIMAU,112,1240,456,149,1845,40,151,392,583,2428,-5.555723734,104.8145809
KELUMBAYAN BARAT,113,1014,368,129,1511,82,137,251,470,1981,-5.648604747,105.0155418
NATAR,60,6930,2415,906,10251,269,896,1910,3075,13326,-5.262955162,105.2179954
JATI AGUNG,70,3933,1257,412,5602,174,534,1115,1823,7425,-5.287970861,105.3534631
TANJUNG BINTANG,80,2780,961,381,4122,112,227,612,951,5073,-5.393279482,105.401498
TANJUNG SARI,81,1898,753,263,2914,97,233,630,960,3874,-5.353071465,105.4778561
KATIBUNG,90,4893,1712,532,7137,336,658,1613,2607,9744,-5.536809394,105.4329956
MERBAU MATARAM,91,2839,998,394,4231,224,368,687,1279,5510,-5.464459891,105.4188846
WAY SULAN,92,1777,688,298,2763,79,169,470,718,3481,-5.477074202,105.5481921
SIDOMULYO,100,3165,1070,350,4585,204,527,958,1689,6274,-5.598327241,105.4894942
CANDIPURO,101,2750,923,298,3971,125,302,626,1053,5024,-5.526198532,105.5599213
WAY PANJI,102,641,208,51,900,24,72,140,236,1136,-5.598644571,105.5934683
KALIANDA,110,4327,1435,574,6336,201,518,1010,1729,8065,-5.683697283,105.5802364
RAJABASA,111,1272,452,121,1845,47,138,332,517,2362,,
PALAS,120,3323,980,312,4615,126,386,826,1338,5953,-5.63090788,105.6633192
SRAGI,121,2188,649,180,3017,59,226,587,872,3889,-5.642631258,105.7540355
PENENGAHAN,130,2143,708,235,3086,49,273,566,888,3974,-5.749805601,105.6877968
KETAPANG,131,2585,751,199,3535,116,344,684,1144,4679,-5.74165646,105.7715002
BAKAUHENI,132,1313,369,129,1811,87,211,351,649,2460,-5.839440848,105.721533
METRO KIBANG,10,1167,410,127,1704,29,85,301,415,2119,-5.202847802,105.3232969
BATANGHARI,20,2165,988,385,3538,98,126,419,643,4181,-5.146456251,105.3753595
SEKAMPUNG,30,2215,874,280,3369,151,217,629,997,4366,-5.164869773,105.4518205
MARGATIGA,40,1887,684,217,2788,117,187,461,765,3553,-5.194194135,105.5135165
SEKAMPUNG UDIK,50,3089,1198,435,4722,557,459,1029,2045,6767,-5.281123613,105.5503314
JABUNG,60,2921,1071,434,4426,214,306,789,1309,5735,-5.502206516,105.6975396
PASIR SAKTI,61,2363,755,273,3391,215,404,703,1322,4713,-5.5387836,105.7780283
WAWAY KARYA,62,2429,839,292,3560,197,305,773,1275,4835,-5.435580953,105.5937114
MARGA SEKAPUNG,63,1406,544,166,2116,100,131,386,617,2733,-5.366078456,105.636547
LABUHAN MARINGGAI,70,4831,1474,441,6746,217,670,1405,2292,9038,-5.344366371,105.8079257
MATARAM BARU,71,1545,600,195,2340,53,138,425,616,2956,-5.272400705,105.7590056
BANDAR SRIBAWONO,72,1834,689,260,2783,85,121,406,612,3395,-5.271888451,105.6775534
MELINTING,73,1387,518,187,2092,192,193,407,792,2884,-5.364388287,105.7412115
GUNUNG PELINDUNG,74,1336,501,126,1963,49,142,454,645,2608,-5.423303441,105.7572856
WAY JEPARA,80,2024,710,237,2971,112,234,534,880,3851,-5.202132229,105.696102
BRAJA SLEBAH,81,1116,412,143,1671,65,114,320,499,2170,-5.195107742,105.7739492
LABUHAN RATU,82,1694,626,157,2477,100,233,525,858,3335,-5.121107066,105.6673024
SUKADANA,90,3559,1433,512,5504,209,318,933,1460,6964,-5.070801543,105.5738431
BUMI AGUNG,91,514,182,74,770,72,54,153,279,1049,-5.113441909,105.5244267
BATANGHARI NUBAN,92,1847,713,274,2834,92,148,526,766,3600,-5.026774488,105.4121102
PEKALONGAN,100,1579,598,192,2369,38,144,338,520,2889,-5.065062474,105.3725219
RAMAN UTARA,110,1119,389,127,1635,23,79,230,332,1967,-4.950478876,105.4427595
PURBOLINGGO,120,1667,659,268,2594,51,90,337,478,3072,-4.975161464,105.5045128
WAY BUNGUR,121,1005,346,109,1460,41,85,253,379,1839,-4.910205586,105.5362912
PADANG RATU,10,1992,680,198,2870,141,323,613,1077,3947,-5.068984812,104.9620532
SELAGAI LINGGA,11,1668,526,85,2279,35,281,511,827,3106,-5.083537819,104.7287923
PUBIAN,12,1877,701,178,2756,57,226,526,809,3565,-5.103661951,104.8579156
ANAK TUHA,13,2121,738,235,3094,121,269,572,962,4056,-5.010015608,105.0559014
ANAK RATU AJI,14,920,284,117,1321,48,116,205,369,1690,-4.957994245,104.9491887
KALIREJO,20,3271,1412,499,5182,81,340,827,1248,6430,-5.209960333,104.9756802
SENDANG AGUNG,21,2066,736,200,3002,39,215,470,724,3726,-5.194452625,104.8816362
BANGUNREJO,30,1994,649,170,2813,73,258,480,811,3624,-5.127614959,105.0377011
GUNUNG SUGIH,40,2278,803,252,3333,120,273,683,1076,4409,-4.993744213,105.2112731
BEKRI,41,746,231,87,1064,34,122,230,386,1450,-5.098990651,105.1333482
BUMI RATU NUBAN,42,1400,606,241,2247,51,127,332,510,2757,-5.088905341,105.2073314
TRIMURJO,50,1161,393,184,1738,46,97,207,350,2088,-5.124157899,105.2527931
PUNGGUR,60,947,452,178,1577,31,65,163,259,1836,-5.035958943,105.2746888
KOTA GAJAH,61,661,284,126,1071,20,34,109,163,1234,-4.994546608,105.3253431
SEPUTIH RAMAN,70,918,330,167,1415,36,59,163,258,1673,-4.89972888,105.367547
TERBANGGI BESAR,80,3324,1214,478,5016,161,394,812,1367,6383,-4.881016072,105.2291503
SEPUTIH AGUNG,81,1436,528,155,2119,57,149,367,573,2692,-4.939966231,105.1295704
WAY PENGUBUAN,82,1234,367,118,1719,54,252,404,710,2429,-4.832372804,105.1670254
TERUSAN NUNYAI,90,1538,516,193,2247,93,202,431,726,2973,-4.710171913,105.2199618
SEPUTIH MATARAM,100,1968,680,190,2838,40,247,488,775,3613,-4.804273707,105.3476399
BANDAR MATARAM,101,2703,667,182,3552,330,588,839,1757,5309,-4.613531171,105.5104927
SEPUTIH BANYAK,110,1419,428,172,2019,55,160,304,519,2538,-4.85055084,105.4782645
WAY SEPUTIH,111,470,119,33,622,49,81,124,254,876,-4.801081737,105.4595783
RUMBIA,120,1216,346,92,1654,45,141,311,497,2151,-4.76481022,105.5810284
BUMI NABUNG,121,1234,466,212,1912,58,118,321,497,2409,-4.682169934,105.5573724
PUTRA RUMBIA,122,943,355,85,1383,46,125,268,439,1822,-4.826937972,105.585897
SEPUTIH SURABAYA,130,1980,555,152,2687,107,358,580,1045,3732,-4.682587233,105.6419262
BANDAR SURABAYA,131,1365,430,96,1891,51,208,392,651,2542,-4.697443947,105.7510169
BUKIT KEMUNING,10,2055,760,339,3154,55,216,459,730,3884,-4.934816123,104.5561844
ABUNG TINGGI,11,1158,446,194,1798,48,94,254,396,2194,-4.880288953,104.6168498
TANJUNG RAJA,20,2161,843,345,3349,89,213,534,836,4185,-4.972699152,104.6535524
ABUNG BARAT,30,1498,557,227,2282,37,160,373,570,2852,-4.855203782,104.7005176
ABUNG TENGAH,31,927,289,116,1332,41,120,202,363,1695,-4.932958145,104.7455527
ABUNG  KUNANG,32,639,232,97,968,28,52,113,193,1161,-4.883040282,104.8074782
ABUNG PEKURUN,33,984,329,133,1446,63,114,246,423,1869,-5.00971807,104.7359455
KOTABUMI,40,3139,1206,606,4951,212,306,763,1281,6232,-4.819810638,104.8582227
KOTABUMI UTARA,41,1540,566,239,2345,60,185,387,632,2977,-4.731374938,104.8601629
KOTABUMI SELATAN,42,2265,926,439,3630,99,204,484,787,4417,-4.890995569,104.8716937
ABUNG SELATAN,50,2328,919,369,3616,86,203,527,816,4432,-4.89452674,104.9308964
ABUNG SEMULI,51,1176,440,140,1756,34,129,345,508,2264,-4.807236704,105.0483742
BLAMBANGAN PAGAR,52,1044,363,145,1552,28,107,232,367,1919,-4.889182796,105.0216022
ABUNG TIMUR,60,1493,642,230,2365,156,183,406,745,3110,-4.747488527,104.9634704
ABUNG SURAKARTA,61,1735,708,284,2727,55,170,450,675,3402,-4.722515409,105.0478213
SUNGKAI SELATAN,70,1588,585,245,2418,46,204,519,769,3187,-4.714025126,104.7851582
MUARA SUNGKAI,71,1165,429,185,1779,66,123,334,523,2302,-4.616514551,104.9618456
BUNGA MAYANG,72,1948,587,227,2762,59,222,552,833,3595,-4.605997177,104.8874247
SUNGKAI  BARAT,73,1287,459,205,1951,61,170,350,581,2532,-4.781318727,104.6805062
SUNGKAI JAYA,74,1057,439,207,1703,51,146,350,547,2250,-4.811720005,104.7505945
SUNGKAI UTARA,80,2630,1100,540,4270,134,254,630,1018,5288,-4.623244273,104.7507992
HULUSUNGKAI,81,1327,504,186,2017,38,103,309,450,2467,-4.656858895,104.6670774
SUNGKAI TENGAH,82,1382,479,197,2058,41,174,407,622,2680,-4.712460555,104.7069293
BANJIT,10,2242,837,353,3432,87,217,540,844,4276,-4.8439028,104.4636849
BARADATU,20,1660,591,261,2512,67,151,421,639,3151,-4.709873281,104.5355532
GUNUNG LABUHAN,21,1843,723,315,2881,42,169,432,643,3524,-4.758530677,104.5917673
KASUI,30,1801,594,267,2662,81,210,461,752,3414,-4.740278628,104.4031231
REBANG TANGKAS,31,1529,487,169,2185,53,195,391,639,2824,-4.669906371,104.3523983
BLAMBANGAN UMPU,40,3113,1187,589,4889,228,336,811,1375,6264,-4.528344892,104.4948833
WAY TUBA,41,944,312,110,1366,58,140,261,459,1825,-4.434417812,104.3876769
NEGERI AGUNG,42,1285,532,264,2081,104,146,293,543,2624,-4.535099518,104.6482303
BAHUGA,50,489,182,72,743,30,60,118,208,951,-4.300748447,104.6410464
BUAY  BAHUGA,51,479,140,34,653,16,56,111,183,836,-4.283976567,104.5537558
BUMI AGUNG,52,1055,302,93,1450,30,116,242,388,1838,-4.345733895,104.531708
PAKUAN RATU,60,1775,615,219,2609,51,196,500,747,3356,-4.422988963,104.762944
NEGARA BATIN,61,1936,674,251,2861,126,310,578,1014,3875,-4.321590056,104.891246
NEGERI BESAR,62,742,289,134,1165,32,91,170,293,1458,-4.450660735,104.9552141
BANJAR AGUNG,30,517,143,42,702,24,81,165,270,972,-4.296264508,105.2420934
BANJAR MARGO,31,514,154,43,711,49,74,187,310,1021,-4.22750036,105.3007254
BANJAR BARU,32,249,60,25,334,30,46,88,164,498,-4.350850504,105.2666416
GEDUNG AJI,40,492,167,49,708,45,94,173,312,1020,-4.282358282,105.4202564
PENAWAR AJI,41,467,157,38,662,35,73,191,299,961,-4.280407976,105.4983047
MERAKSA AJI,42,417,139,46,602,11,66,108,185,787,-4.273250143,105.4352362
MENGGALA,50,1018,353,170,1541,92,184,266,542,2083,-4.531902347,105.2202793
PENAWAR TAMA,51,638,199,49,886,43,135,257,435,1321,-4.178358776,105.4351115
RAWAJITU SELATAN,52,788,271,94,1153,42,150,296,488,1641,-4.237270633,105.709244
GEDUNG MENENG,53,982,363,122,1467,93,164,395,652,2119,-4.431902417,105.5008971
RAWAJITU TIMUR,54,361,145,61,567,5,3,28,36,603,-4.244912344,105.7976602
RAWA PITU,55,717,260,90,1067,15,81,230,326,1393,-4.307262621,105.5966649
GEDUNG AJI BARU,56,796,347,122,1265,65,108,307,480,1745,-4.224648857,105.5792631
DENTE TELADAS,57,2092,577,139,2808,257,381,634,1272,4080,-4.502927727,105.8138372
MENGGALA TIMUR,58,658,197,75,930,65,116,256,437,1367,-4.399445895,105.2951611
PUNDUH PIDADA,10,2200,893,530,3623,119,196,531,846,4469,-5.732936254,105.1933648
PADANG CERMIN,20,5635,2101,903,8639,333,547,1424,2304,10943,,
KEDONDONG,30,4950,1859,801,7610,196,700,1438,2334,9944,-5.50315841,104.9931193
WAY LIMA,40,2093,909,411,3413,100,217,636,953,4366,-5.430530233,105.0231556
GEDUNG TATAAN,50,3568,1463,706,5737,119,282,803,1204,6941,-5.390253085,105.1177553
NEGERI KATON,60,3101,1295,504,4900,124,358,908,1390,6290,-5.287061276,105.1038126
TEGINENENG,70,2378,1037,473,3888,112,185,666,963,4851,-5.180379359,105.1388746
PARDASUKA,10,1994,673,208,2875,79,328,608,1015,3890,-5.499280577,104.9158708
AMBARAWA,20,1119,527,215,1861,70,80,216,366,2227,-5.410385415,104.9427289
PAGELARAN,30,2380,991,314,3685,110,262,558,930,4615,-5.283323531,104.8436901
PRINGSEWU,40,2044,861,298,3203,67,170,481,718,3921,-5.356656208,104.9569968
GADING REJO,50,2507,1028,333,3868,75,226,565,866,4734,-5.366087352,105.0222774
SUKOHARJO,60,1633,556,221,2410,53,159,318,530,2940,-5.303738757,104.9797152
BANYUMAS,70,604,222,57,883,40,85,177,302,1185,-5.286527541,104.9075713
ADI LUWIH,80,1048,392,120,1560,45,115,284,444,2004,-5.25110534,105.0111083
WAY SERDANG,10,820,221,34,1075,83,142,311,536,1611,-4.121975126,105.1407553
SIMPANG PEMATANG,20,358,80,18,456,19,63,103,185,641,-3.985124011,105.1881602
PANCA JAYA,30,306,76,22,404,39,56,78,173,577,,
TANJUNG RAYA,40,353,97,26,476,40,63,128,231,707,-3.925391147,105.3697551
MESUJI,50,944,311,107,1362,45,125,268,438,1800,-3.891547524,105.4733288
MESUJI TIMUR,60,1434,497,154,2085,55,163,391,609,2694,-4.071884226,105.4150476
RAWAJITU UTARA,70,880,257,57,1194,43,151,252,446,1640,-4.142396668,105.6528399
TULANG BAWANG UDIK,10,458,144,39,641,58,78,126,262,903,-4.553183387,105.0229395
TUMI JAJAR,20,873,291,75,1239,41,108,245,394,1633,-4.665174968,105.0940904
TULANG BAWANG TENGAH,30,1944,754,267,2965,91,198,482,771,3736,-4.536105768,105.1297191
PAGAR DEWA,40,201,66,16,283,23,39,75,137,420,-4.418159421,105.1608309
LAMBU KIBANG,50,537,175,39,751,24,106,186,316,1067,-4.350945642,105.1618758
GUNUNG TERANG,60,1187,451,115,1753,52,185,376,613,2366,-4.343980569,105.0505376
GUNUNG AGUNG,70,1125,384,98,1607,67,177,407,651,2258,-4.227649322,105.0384208
WAY KENANGA,80,437,182,49,668,103,122,192,417,1085,-4.230416247,105.1754494
TELUK BETUNG BARAT,10,4123,1641,783,6547,299,464,1110,1873,8420,-5.461195028,105.2398018
TELUK BETUNG SELATAN,20,5931,2248,1030,9209,232,589,1596,2417,11626,-5.44395302,105.2867095
PANJANG,30,2769,1205,543,4517,116,271,719,1106,5623,-5.463267991,105.3264702
TANJUNG KARANG TIMUR,40,2816,1176,599,4591,184,320,782,1286,5877,-5.416187153,105.2995542
TELUK BETUNG UTARA,50,2760,1107,571,4438,167,290,692,1149,5587,-5.434555726,105.2433605
TANJUNG KARANG PUSAT,60,2999,1356,649,5004,78,195,760,1033,6037,-5.415194007,105.2519806
TANJUNG KARANG BARAT,70,2287,905,483,3675,75,161,461,697,4372,-5.406404585,105.2343162
KEMILING,71,2226,979,507,3712,102,160,465,727,4439,-5.400175393,105.2066847
KEDATON,80,2567,1120,633,4320,120,150,532,802,5122,-5.377906528,105.2602515
RAJABASA,81,1243,532,268,2043,67,105,287,459,2502,-5.36023709,105.241156
TANJUNG SENANG,82,1017,440,226,1683,40,63,206,309,1992,-5.359026573,105.2753628
SUKARAME,90,1837,764,475,3076,70,99,332,501,3577,-5.382066588,105.2955194
SUKABUMI,91,2064,943,553,3560,61,103,334,498,4058,-5.40043539,105.2920601
METRO SELATAN,11,356,151,89,596,3,20,73,96,692,-5.164573494,105.301618
METRO BARAT,12,388,196,103,687,8,25,69,102,789,-5.138921708,105.2863317
METRO TIMUR,21,681,297,192,1170,20,35,128,183,1353,-5.127430026,105.32356
METRO PUSAT,22,1377,623,377,2377,44,57,238,339,2716,-5.10584448,105.3100616
METRO UTARA,23,508,191,95,794,15,42,131,188,982,-5.08149171,105.3097685
MENDO BARAT,70,1754,685,296,2735,67,195,382,644,3379,-2.177947897,105.9167109
MERAWANG,80,576,217,88,881,19,69,122,210,1091,-2.007570921,106.0835819
PUDING BESAR,81,860,329,108,1297,48,107,192,347,1644,-2.051482028,105.852307
SUNGAI LIAT,90,905,317,118,1340,60,111,134,305,1645,-1.875378168,106.1209914
PEMALI,91,210,94,27,331,20,25,46,91,422,-1.883421539,106.0374706
BAKAM,92,546,195,90,831,30,53,101,184,1015,-1.912229339,105.8728836
BELINYU,130,787,256,108,1151,29,79,178,286,1437,-1.628038443,105.841719
RIAU SILIP,131,686,240,78,1004,52,111,155,318,1322,-1.754290208,105.9282073
MEMBALONG,10,820,291,93,1204,49,208,282,539,1743,-3.042970503,107.701061
TANJUNG PANDAN,60,1510,623,237,2370,61,171,375,607,2977,-2.757625077,107.6953476
BADAU,61,424,121,29,574,20,89,164,273,847,-2.798142428,107.7829599
SIJUK,62,880,315,147,1342,41,128,195,364,1706,-2.626706815,107.7682028
SELAT NASIK,63,271,72,24,367,16,66,113,195,562,-2.885440789,107.4206787
KELAPA,10,804,233,75,1112,108,162,159,429,1541,-1.866195849,105.6107242
TEMPILANG,20,415,98,32,545,32,78,86,196,741,-2.040414046,105.6495782
MENTOK,30,441,127,44,612,40,43,73,156,768,-2.025965865,105.2272841
SIMPANG TERITIP,40,830,225,69,1124,163,148,194,505,1629,-1.960370159,105.4023862
JEBUS,50,383,99,28,510,38,58,84,180,690,-1.674490924,105.5225958
PARITTIGA,51,378,84,23,485,27,32,52,111,596,,
KOBA,10,822,206,107,1135,104,133,179,416,1551,-2.497037367,106.3145218
LUBUK BESAR,11,925,249,123,1297,86,146,212,444,1741,-2.595390734,106.6033218
PANGKALAN BARU,20,948,271,133,1352,68,112,179,359,1711,-2.193348862,106.1386193
NAMANG,21,428,133,57,618,45,64,93,202,820,-2.3294223,106.2006765
SUNGAI SELAN,30,1154,373,150,1677,80,169,258,507,2184,-2.395986211,106.0223982
SIMPANG KATIS,40,596,136,52,784,50,101,113,264,1048,-2.281827445,106.090548
PAYUNG,10,292,76,30,398,31,56,75,162,560,-2.629124839,106.140062
PULAU BESAR,11,187,64,27,278,16,45,53,114,392,-2.798680441,106.1465584
SIMPANG RIMBA,20,172,45,32,249,18,32,28,78,327,-2.63840181,105.9879346
TOBOALI,30,760,253,98,1111,48,108,198,354,1465,-2.896212082,106.4970681
TUKAK SADAI,31,215,48,12,275,25,36,72,133,408,-3.032036746,106.6448717
AIR GEGAS,40,382,96,29,507,72,79,133,284,791,-2.71292373,106.3715451
LEPAR PONGOK,50,363,103,43,509,17,63,88,168,677,-2.943079108,106.8560709
DENDANG,10,306,89,20,415,23,57,85,165,580,-2.980746906,107.8867832
SIMPANG PESAK,11,188,85,36,309,29,27,40,96,405,-3.161686284,108.0057588
GANTUNG,20,331,85,29,445,19,69,115,203,648,-3.032998243,108.1225993
SIMPANG RENGGIANG,21,46,9,9,64,14,11,12,37,101,-2.881706102,107.9915903
MANGGAR,30,500,188,98,786,44,59,133,236,1022,-2.880465754,108.2279504
DAMAR,31,100,65,67,232,21,1,3,25,257,-2.773722386,108.1956499
KELAPA KAMPIT,40,339,109,49,497,12,18,65,95,592,-2.693825007,108.0220701
RANGKUI,10,662,282,141,1085,37,45,123,205,1290,-2.133074387,106.1086702
BUKIT INTAN,20,640,285,129,1054,40,56,128,224,1278,-2.126378201,106.1504125
GIRIMAYA,21,393,179,72,644,23,36,89,148,792,,
PANGKAL BALAM,30,400,189,78,667,28,36,73,137,804,-2.088002255,106.1161338
GABEK,31,401,203,79,683,7,18,81,106,789,,
TAMAN SARI,40,312,160,74,546,29,25,90,144,690,-2.120826163,106.1133159
GERUNGGANG,41,684,267,157,1108,36,45,133,214,1322,-2.103073002,106.0722864
MORO,10,837,350,199,1386,42,75,134,251,1637,0.814988087,103.798546
DURAI,11,254,108,44,406,50,27,85,162,568,0.559939225,103.6367878
KUNDUR,20,767,299,192,1258,84,89,150,323,1581,0.683980834,103.4664557
KUNDUR UTARA,21,630,233,133,996,39,67,120,226,1222,0.802624098,103.4577481
KUNDUR BARAT,22,725,291,174,1190,50,81,157,288,1478,0.774809635,103.3822498
KARIMUN,30,458,169,66,693,24,45,74,143,836,0.948332943,103.4328401
BURU,31,545,233,153,931,43,51,79,173,1104,0.891055431,103.4669606
MERAL,32,792,302,180,1274,163,146,194,503,1777,1.053541094,103.349289
TEBING,33,438,164,109,711,16,29,100,145,856,1.077284945,103.3824726
TELUK BINTAN,40,219,95,57,371,55,30,51,136,507,1.042338933,104.4556442
BINTAN UTARA,50,572,222,125,919,19,17,70,106,1025,1.081215176,104.2555496
TELUK SEBONG,51,517,187,96,800,31,29,84,144,944,1.134268307,104.4139624
SERI KUALA LOBAM,52,385,100,53,538,7,19,42,68,606,1.027392771,104.2937841
BINTAN TIMUR,60,738,314,105,1157,35,49,154,238,1395,0.86271675,104.5693908
GUNUNG KIJANG,61,362,139,77,578,24,23,63,110,688,1.031810408,104.6060892
MANTANG,62,169,49,21,239,38,46,40,124,363,0.775902171,104.5935802
BINTAN PESISIR,63,335,109,37,481,22,32,83,137,618,0.861909605,104.7268687
TOAPAYA,64,280,92,35,407,10,13,38,61,468,1.020257112,104.5475169
TAMBELAN,70,462,155,103,720,15,30,79,124,844,0.939711303,107.4506342
MIDAI,30,79,21,12,112,1,4,4,9,121,2.996645189,107.7799226
BUNGURAN BARAT,40,267,105,80,452,19,16,33,68,520,3.841910654,108.1520679
BUNGURAN UTARA,41,90,48,23,161,2,1,13,16,177,4.033317429,108.0982913
PULAU LAUT,42,36,12,12,60,0,0,1,1,61,4.711479854,107.9679454
PULAU TIGA,43,188,91,39,318,2,7,11,20,338,3.644801392,108.1005024
BUNGURAN TIMUR,50,169,57,41,267,4,13,15,32,299,3.906394429,108.343334
BUNGURAN TIMUR LAUT,51,51,11,10,72,4,5,13,22,94,4.054860882,108.2460907
BUNGURAN TENGAH,52,63,26,23,112,1,3,9,13,125,3.927410719,108.2566254
BUNGURAN SELATAN,53,54,22,9,85,2,0,4,6,91,3.743391288,108.2846735
SERASAN,60,68,29,25,122,2,5,12,19,141,2.522127984,109.016622
SUBI,61,46,20,10,76,2,3,8,13,89,2.908574338,108.836631
SERASAN TIMUR,62,54,23,14,91,3,2,5,10,101,2.510359857,109.0885405
SINGKEP BARAT,10,212,64,27,303,30,51,76,157,460,-0.462078652,104.3673187
SINGKEP,20,249,121,70,440,18,22,76,116,556,-0.522957569,104.4816844
LINGGA,30,687,275,100,1062,53,65,157,275,1337,-0.206738399,104.6142134
LINGGA UTARA,40,477,168,81,726,34,38,88,160,886,-0.139209581,104.7158157
SENAYANG,50,1131,311,143,1585,180,185,297,662,2247,0.167576662,104.4917257
JEMAJA,10,85,22,17,124,6,12,13,31,155,3.00819561,105.7038751
JEMAJA TIMUR,20,67,26,14,107,0,4,8,12,119,2.915087177,105.7653009
SIANTAN SELATAN,30,75,18,1,94,9,7,4,20,114,2.983721116,106.1673729
SIANTAN,40,135,83,48,266,14,21,20,55,321,3.205759427,106.2376214
SIANTAN TIMUR,50,83,48,21,152,11,11,13,35,187,3.13697217,106.3432984
SIANTAN TENGAH,60,21,12,6,39,2,4,5,11,50,3.259514101,106.2811361
PAL MATAK,70,295,121,75,491,14,18,28,60,551,3.33637282,106.2656521
BELAKANG PADANG,10,900,420,247,1567,129,75,243,447,2014,1.043778016,103.8171342
BULANG,20,902,375,242,1519,37,60,197,294,1813,0.970687091,103.9325118
GALANG,30,1230,405,247,1882,128,145,343,616,2498,0.791355225,104.2031226
SEI BEDUK,40,2266,656,327,3249,155,47,138,340,3589,1.046981532,104.0565919
SAGULUNG,41,4731,1338,703,6772,295,117,431,843,7615,1.021929588,103.9869424
NONGSA,50,1529,565,354,2448,107,75,196,378,2826,1.10885245,104.1248071
BATAM KOTA,51,1585,387,200,2172,232,70,200,502,2674,1.118664182,104.0581087
SEKUPANG,60,2381,640,279,3300,74,51,195,320,3620,1.101831848,103.9624639
BATU AJI,61,2225,492,234,2951,68,44,195,307,3258,1.060828533,103.9458957
LUBUK BAJA,70,2159,669,354,3182,185,140,296,621,3803,1.134145616,104.0060859
BATU AMPAR,80,1900,591,362,2853,152,77,223,452,3305,1.169428342,104.0106948
BENGKONG,81,2912,988,575,4475,79,51,241,371,4846,1.15667205,104.0366202
BUKIT BESTARI,10,1214,500,305,2019,48,55,202,305,2324,0.877261834,104.4824441
TANJUNGPINANG TIMUR,20,2208,787,442,3437,54,72,274,400,3837,0.924361632,104.509587
TANJUNGPINANG KOTA,30,745,349,200,1294,69,48,176,293,1587,0.958277714,104.4559058
TANJUNGPINANG BARAT,40,1080,464,284,1828,31,36,160,227,2055,0.915945166,104.4467712
KEPULAUAN SERIBU SELATAN,10,442,167,60,669,15,24,94,133,802,-5.901437032,106.6214422
KEPULAUAN SERIBU UTARA,20,698,327,178,1203,18,31,142,191,1394,-5.572275243,106.552619
JAGAKARSA,10,3864,1733,1138,6735,187,136,577,900,7635,-6.33404605,106.8222637
PASAR MINGGU,20,4040,1887,1108,7035,213,182,845,1240,8275,-6.290661917,106.8293094
CILANDAK,30,2308,1105,594,4007,65,90,461,616,4623,-6.292745677,106.7933103
PESANGGRAHAN,40,2992,1370,734,5096,164,150,661,975,6071,-6.249919791,106.758618
KEBAYORAN LAMA,50,3523,1610,861,5994,114,174,780,1068,7062,-6.249171277,106.7799398
KEBAYORAN BARU,60,1895,857,454,3206,80,98,433,611,3817,-6.24475111,106.801412
MAMPANG PRAPATAN,70,2139,1058,611,3808,70,119,468,657,4465,-6.25226846,106.8209534
PANCORAN,80,1552,753,378,2683,56,81,340,477,3160,-6.255353748,106.8436104
TEBET,90,3600,1638,833,6071,146,198,870,1214,7285,-6.228812305,106.8507115
SETIA BUDI,100,1436,691,366,2493,74,82,325,481,2974,-6.219591316,106.8298768
PASAR REBO,10,2539,1268,664,4471,108,106,502,716,5187,-6.327117931,106.8568114
CIRACAS,20,1891,898,449,3238,74,104,374,552,3790,-6.333634583,106.8783116
CIPAYUNG,30,3049,1458,742,5249,112,140,672,924,6173,-6.325291394,106.9034653
MAKASAR,40,3127,1494,782,5403,95,95,592,782,6185,-6.266405839,106.8911845
KRAMAT JATI,50,2886,1282,691,4859,186,216,723,1125,5984,-6.276215712,106.8654648
JATINEGARA,60,5780,2614,1294,9688,351,473,1563,2387,12075,-6.227654968,106.8774319
DUREN SAWIT,70,4364,1928,1028,7320,228,272,1028,1528,8848,-6.232474436,106.9204169
CAKUNG,80,9909,4294,2255,16458,635,619,2134,3388,19846,-6.188741675,106.9403369
PULO GADUNG,90,3863,1712,911,6486,214,284,917,1415,7901,-6.193299382,106.8889122
MATRAMAN,100,2591,1169,577,4337,74,100,547,721,5058,-6.203772105,106.8645227
TANAH ABANG,10,2584,1138,475,4197,74,150,556,780,4977,-6.205510528,106.8092941
MENTENG,20,1463,693,321,2477,44,75,370,489,2966,-6.195782809,106.8351718
SENEN,30,2178,956,457,3591,98,143,544,785,4376,-6.184268513,106.8458614
JOHAR BARU,40,3463,1452,582,5497,117,265,854,1236,6733,-6.182123794,106.8545403
CEMPAKA PUTIH,50,876,396,174,1446,8,33,186,227,1673,-6.180883411,106.8680462
KEMAYORAN,60,3892,1796,753,6441,113,187,829,1129,7570,-6.16282189,106.8558983
SAWAH BESAR,70,1703,782,337,2822,46,95,398,539,3361,-6.153836177,106.8332349
GAMBIR,80,1373,571,256,2200,58,92,382,532,2732,-6.171464384,106.8180802
KEMBANGAN,10,2759,1287,706,4752,110,167,660,937,5689,-6.198377399,106.7417599
KEBON JERUK,20,3445,1644,927,6016,185,214,832,1231,7247,-6.188963239,106.7690259
PALMERAH,30,1673,782,382,2837,62,147,506,715,3552,-6.191744758,106.7955528
GROGOL PETAMBURAN,40,2204,951,404,3559,89,157,565,811,4370,-6.163435669,106.7864384
TAMBORA,50,3704,1571,717,5992,210,424,1282,1916,7908,-6.147388377,106.8033734
TAMAN SARI,60,1478,687,262,2427,126,213,548,887,3314,-6.148284172,106.8182622
CENGKARENG,70,10745,4539,2123,17407,517,879,3013,4409,21816,-6.152220489,106.7365367
KALI DERES,80,7987,3459,1720,13166,427,672,2324,3423,16589,-6.134527496,106.7042754
PENJARINGAN,10,7297,2646,1226,11169,492,768,2262,3522,14691,-6.118124314,106.7665319
PADEMANGAN,20,3643,1498,684,5825,243,344,1138,1725,7550,,
TANJUNG PRIOK,30,5320,2585,1385,9290,245,356,1368,1969,11259,-6.132077397,106.8749001
KOJA,40,8518,3879,1846,14243,505,645,2314,3464,17707,-6.121113345,106.9048773
KELAPA GADING,50,1635,623,324,2582,60,90,388,538,3120,-6.160768472,106.9035302
CILINCING,60,12789,5492,2889,21170,594,1002,3386,4982,26152,-6.126807791,106.9437635
NANGGUNG,10,5244,1139,308,6691,468,1427,1839,3734,10425,-6.672647424,106.5375482
LEUWILIANG,20,7429,1965,634,10028,482,1362,2158,4002,14030,-6.639782343,106.6093508
LEUWISADENG,21,5069,1484,389,6942,287,942,1624,2853,9795,-6.572324193,106.5874926
PAMIJAHAN,30,7544,2321,788,10653,596,1302,2345,4243,14896,-6.69329014,106.6594376
CIBUNGBULANG,40,5374,1702,493,7569,266,893,1703,2862,10431,-6.576260588,106.6610721
CIAMPEA,50,4224,1467,409,6100,257,571,1246,2074,8174,-6.574047734,106.6982528
TENJOLAYA,51,3234,996,360,4590,166,555,1089,1810,6400,-6.654015444,106.7079486
DRAMAGA,60,2815,771,190,3776,170,600,868,1638,5414,-6.58878858,106.729951
CIOMAS,70,2181,612,190,2983,174,407,721,1302,4285,-6.608629194,106.7622495
TAMANSARI,71,2178,496,119,2793,315,703,870,1888,4681,-6.655795463,106.7460953
CIJERUK,80,4593,1250,365,6208,571,1126,1655,3352,9560,-6.685778733,106.7836872
CIGOMBONG,81,2996,959,255,4210,105,413,850,1368,5578,-6.745841064,106.8139123
CARINGIN,90,6462,2039,507,9008,312,1067,1868,3247,12255,-6.736570143,106.8655568
CIAWI,100,3476,1136,418,5030,248,636,1086,1970,7000,-6.70953511,106.8937457
CISARUA,110,2594,959,321,3874,151,427,926,1504,5378,-6.698968858,106.9561344
MEGAMENDUNG,120,2776,887,229,3892,198,602,1094,1894,5786,-6.664107541,106.9174971
SUKARAJA,130,3169,1235,645,5049,302,553,1001,1856,6905,-6.579949947,106.8403588
BABAKAN MADANG,140,2193,732,310,3235,408,632,901,1941,5176,-6.5915813,106.9015992
SUKAMAKMUR,150,5895,1679,466,8040,792,1226,1983,4001,12041,-6.592124804,107.0180343
CARIU,160,1153,351,72,1576,48,189,341,578,2154,-6.527022357,107.1372733
TANJUNGSARI,161,1497,316,71,1884,110,413,479,1002,2886,-6.612059888,107.1377889
JONGGOL,170,3327,1083,475,4885,419,621,1053,2093,6978,-6.495463977,107.0469673
CILEUNGSI,180,1102,309,58,1469,33,206,349,588,2057,-6.409775022,106.9961522
KELAPA NUNGGAL,181,2033,665,192,2890,274,519,807,1600,4490,-6.48315882,106.955215
GUNUNG PUTRI,190,833,295,85,1213,50,138,246,434,1647,-6.405010749,106.9312617
CITEUREUP,200,3221,1011,376,4608,420,696,1146,2262,6870,-6.524802503,106.8925285
CIBINONG,210,2209,815,283,3307,62,175,519,756,4063,-6.484212417,106.8355206
BOJONG GEDE,220,1865,747,378,2990,79,166,377,622,3612,-6.47750627,106.7919676
TAJUR HALANG,221,1756,606,232,2594,72,194,407,673,3267,-6.467830163,106.7591896
KEMANG,230,1986,803,334,3123,98,229,534,861,3984,-6.502780042,106.7345216
RANCA BUNGUR,231,2388,811,273,3472,92,286,636,1014,4486,-6.521803492,106.7133056
PARUNG,240,1818,653,321,2792,206,326,588,1120,3912,-6.435132238,106.7130303
CISEENG,241,4964,1622,576,7162,383,995,1745,3123,10285,-6.455673513,106.6785968
GUNUNG SINDUR,250,2200,811,294,3305,104,317,679,1100,4405,-6.387298126,106.6866873
RUMPIN,260,5620,2070,1183,8873,1110,1192,1642,3944,12817,-6.45978942,106.6311369
CIGUDEG,270,6453,1556,416,8425,792,1950,2631,5373,13798,-6.493218469,106.5469133
SUKAJAYA,271,6156,1106,347,7609,547,1874,2407,4828,12437,-6.631349946,106.4705086
JASINGA,280,6571,2130,550,9251,358,1300,2451,4109,13360,-6.481935951,106.4566139
TENJO,290,4582,1496,467,6545,361,859,1649,2869,9414,-6.372813304,106.4794581
PARUNG PANJANG,300,3690,1084,429,5203,518,928,1386,2832,8035,-6.376702389,106.5549795
CIEMAS,10,2952,806,195,3953,287,606,882,1775,5728,-7.207281129,106.4832204
CIRACAP,20,2244,654,179,3077,162,441,743,1346,4423,-7.322275162,106.468858
WALURAN,21,1682,451,117,2250,115,334,540,989,3239,-7.20909896,106.5999117
SURADE,30,2879,845,278,4002,139,469,812,1420,5422,-7.343351921,106.5624893
CIBITUNG,31,1160,301,73,1534,71,208,360,639,2173,-7.363748972,106.6278971
JAMPANG KULON,40,1666,542,172,2380,79,238,450,767,3147,-7.252541985,106.6392053
CIMANGGU,41,1509,426,77,2012,107,356,494,957,2969,-7.235741656,106.6807436
KALI BUNDER,50,1611,395,84,2090,99,343,406,848,2938,-7.260367605,106.7174831
TEGAL BULEUD,60,1050,230,58,1338,91,225,339,655,1993,-7.356007109,106.7439797
CIDOLOG,70,429,124,32,585,23,58,101,182,767,-7.287483416,106.8587205
SAGARANTEN,80,2063,604,148,2815,125,307,549,981,3796,-7.201295578,106.8741749
CIDADAP,81,939,340,69,1348,40,78,204,322,1670,-7.299478471,106.9212676
CURUGKEMBAR,82,1313,399,116,1828,89,172,319,580,2408,-7.195769887,106.9468362
PABUARAN,90,2562,786,237,3585,259,394,650,1303,4888,-7.192547538,106.7872392
LENGKONG,100,2277,688,156,3121,132,406,724,1262,4383,-7.113744827,106.6848529
PELABUHAN RATU,110,6782,2514,939,10235,347,846,2006,3199,13434,-6.97596936,106.5753935
SIMPENAN,111,3287,1043,272,4602,181,564,1007,1752,6354,-7.0819059,106.5885547
WARUNG KIARA,120,4518,1573,504,6595,225,503,1398,2126,8721,-6.992596981,106.7218843
BANTARGADUNG,121,3522,1261,335,5118,197,560,1176,1933,7051,-6.971546949,106.6638764
JAMPANG TENGAH,130,3666,1136,317,5119,207,595,1131,1933,7052,-7.068108903,106.7904361
PURABAYA,131,2483,888,239,3610,195,392,693,1280,4890,-7.100071279,106.8851393
CIKEMBAR,140,3082,1143,416,4641,221,375,902,1498,6139,-6.974233202,106.798229
NYALINDUNG,150,2498,848,221,3567,107,394,793,1294,4861,-7.014088602,106.924149
GEGER BITUNG,160,2631,895,286,3812,106,377,722,1205,5017,-6.992705085,107.0089503
SUKARAJA,170,4366,1349,549,6264,417,813,1399,2629,8893,-6.881321033,106.9776118
KEBONPEDES,171,1343,556,226,2125,45,141,389,575,2700,-6.944561183,106.9696254
CIREUNGHAS,172,2010,772,261,3043,58,239,564,861,3904,-6.936833844,107.024121
SUKALARANG,173,2496,795,274,3565,178,516,916,1610,5175,-6.88380797,107.0126659
SUKABUMI,180,1514,586,234,2334,76,155,374,605,2939,-6.856850799,106.9565374
KADUDAMPIT,190,3834,1562,826,6222,166,273,890,1329,7551,-6.826694067,106.9350087
CISAAT,200,4782,1875,803,7460,154,503,1403,2060,9520,-6.901968629,106.8897823
GUNUNGGURUH,201,1970,608,250,2828,156,323,639,1118,3946,-6.949204202,106.8754882
CIBADAK,210,6661,2433,854,9948,230,730,2067,3027,12975,-6.894731658,106.7628796
CICANTAYAN,211,3310,1348,543,5201,150,270,800,1220,6421,-6.921518328,106.8299732
CARINGIN,212,2663,1018,428,4109,163,360,832,1355,5464,-6.85031842,106.8818198
NAGRAK,220,5369,1900,494,7763,162,618,1566,2346,10109,-6.843285106,106.8384764
CIAMBAR,221,3091,1009,206,4306,112,487,1079,1678,5984,-6.81388056,106.8218856
CICURUG,230,4191,1594,540,6325,238,610,1448,2296,8621,-6.766670914,106.7828396
CIDAHU,240,4343,1662,383,6388,133,603,1492,2228,8616,-6.766169335,106.7315341
PARAKAN SALAK,250,3416,1429,436,5281,75,287,979,1341,6622,-6.791203475,106.7051116
PARUNG KUDA,260,4125,1556,447,6128,202,634,1509,2345,8473,-6.840515119,106.7512783
BOJONG GENTENG,261,2715,1047,345,4107,185,305,790,1280,5387,-6.834699399,106.7209473
KALAPA NUNGGAL,270,3544,1331,428,5303,151,554,1106,1811,7114,-6.814249523,106.6666077
CIKIDANG,280,5630,1473,287,7390,333,1320,1991,3644,11034,-6.890732748,106.6366706
CISOLOK,290,5131,1663,491,7285,243,1000,1724,2967,10252,-6.878077631,106.4598029
CIKAKAK,291,3150,1019,230,4399,35,409,925,1369,5768,-6.89279011,106.5267951
KABANDUNGAN,300,3932,1227,368,5527,207,788,1192,2187,7714,-6.785889996,106.5950418
AGRABINTA,10,1244,348,112,1704,81,213,385,679,2383,-7.393880664,106.8961264
LELES,11,1078,422,112,1612,94,146,327,567,2179,-7.34002957,107.0180828
SINDANGBARANG,20,1792,537,164,2493,143,423,616,1182,3675,-7.427442609,107.1123883
CIDAUN,30,5171,1639,399,7209,189,770,1601,2560,9769,-7.407652868,107.3782134
NARINGGUL,40,3186,883,197,4266,214,556,1077,1847,6113,-7.35192577,107.3337775
CIBINONG,50,3099,986,270,4355,218,600,1059,1877,6232,-7.326311967,107.1493669
CIKADU,51,2114,720,167,3001,209,439,688,1336,4337,-7.31266087,107.2553214
TANGGEUNG,60,4082,1185,312,5579,169,672,1264,2105,7684,-7.256764844,107.1207132
PASIRKUDA,61,3027,847,188,4062,230,768,1156,2154,6216,-7.203422771,107.2211354
KADUPANDAK,70,2477,632,165,3274,346,688,852,1886,5160,-7.214650528,107.0269461
CIJATI,71,2182,889,340,3411,380,313,579,1272,4683,-7.281820816,107.0151143
TAKOKAK,80,1882,516,152,2550,281,414,602,1297,3847,-7.106090448,106.98641
SUKANAGARA,90,2770,923,345,4038,235,499,830,1564,5602,-7.100512048,107.0903089
PAGELARAN,100,3535,1106,304,4945,364,678,1162,2204,7149,-7.157411027,107.1786552
CAMPAKA,110,4376,1209,288,5873,223,923,1606,2752,8625,-7.005215224,107.1121809
CAMPAKA MULYA,111,1047,355,65,1467,51,215,385,651,2118,-7.077099934,107.215482
CIBEBER,120,6660,2146,747,9553,676,1385,2303,4364,13917,-6.935416353,107.139743
WARUNGKONDANG,130,3618,980,257,4855,820,1237,1622,3679,8534,-6.854422848,107.0699705
GEKBRONG,131,3574,1119,341,5034,329,664,1126,2119,7153,-6.873104624,107.0480924
CILAKU,140,4682,1548,601,6831,516,967,1647,3130,9961,-6.868595257,107.1512061
SUKALUYU,150,4879,1624,411,6914,385,941,1716,3042,9956,-6.831416681,107.2196964
BOJONGPICUNG,160,3555,1072,290,4917,300,778,1344,2422,7339,-6.88831892,107.2556363
HAURWANGI,161,3522,896,226,4644,658,982,1545,3185,7829,-6.850483137,107.3113974
CIRANJANG,170,4325,1530,448,6303,308,648,1429,2385,8688,-6.809676241,107.2646038
MANDE,180,4276,1283,343,5902,779,1123,1829,3731,9633,-6.757938046,107.1828464
KARANGTENGAH,190,5793,2028,557,8378,793,1065,2216,4074,12452,-6.806096099,107.1884338
CIANJUR,200,6665,2576,1098,10339,553,741,1805,3099,13438,-6.818940484,107.1307434
CUGENANG,210,6165,1521,366,8052,586,1743,2576,4905,12957,-6.800986883,107.0654167
PACET,220,5107,1599,592,7298,391,901,1602,2894,10192,-6.749382572,107.0392714
CIPANAS,221,4702,1550,467,6719,481,947,1642,3070,9789,-6.71412155,107.0160019
SUKARESMI,230,4195,1056,170,5421,345,958,1450,2753,8174,-6.70970682,107.1024771
CIKALONGKULON,240,5247,1650,402,7299,666,1117,1793,3576,10875,-6.681172563,107.2076985
CIWIDEY,10,3022,853,253,4128,260,676,997,1933,6061,-7.089407898,107.4383835
RANCABALI,11,2435,720,171,3326,218,487,825,1530,4856,-7.168887829,107.3499287
PASIRJAMBU,20,5083,1412,325,6820,326,997,1897,3220,10040,-7.175198558,107.4575898
CIMAUNG,30,4448,1433,488,6369,246,737,1558,2541,8910,-7.11344383,107.5726216
PANGALENGAN,40,8876,2484,674,12034,601,1466,2798,4865,16899,-7.203765736,107.5698161
KERTASARI,50,5051,1452,417,6920,518,1031,1817,3366,10286,-7.241174803,107.6790832
PACET,60,9967,3504,1016,14487,357,1624,3515,5496,19983,-7.134179804,107.6970942
IBUN,70,6292,1833,558,8683,400,1186,2106,3692,12375,-7.121626895,107.7681966
PASEH,80,8222,2371,643,11236,436,1522,2737,4695,15931,-7.06883396,107.7955169
CIKANCUNG,90,6151,1913,553,8617,303,1097,2273,3673,12290,-7.031536034,107.8238116
CICALENGKA,100,5870,2220,834,8924,259,736,1633,2628,11552,-6.986612568,107.8608237
NAGREG,101,3469,1279,390,5138,143,478,1058,1679,6817,-7.028316897,107.8872977
RANCAEKEK,110,5809,2379,918,9106,165,623,1918,2706,11812,-6.980120513,107.766938
MAJALAYA,120,8720,3039,1001,12760,294,1123,2842,4259,17019,-7.053676699,107.7433765
SOLOKAN JERUK,121,3600,1378,437,5415,138,477,1265,1880,7295,-7.010852467,107.7489085
CIPARAY,130,8482,3198,1280,12960,327,1072,2656,4055,17015,-7.045415287,107.6981085
BALEENDAH,140,6374,2185,758,9317,304,1002,2291,3597,12914,-7.012314795,107.6387965
ARJASARI,150,4322,1395,461,6178,252,856,1543,2651,8829,-7.06724413,107.6411292
BANJARAN,160,3831,1437,477,5745,106,404,1292,1802,7547,-7.079835628,107.595741
CANGKUANG,161,2333,789,218,3340,118,377,901,1396,4736,-7.057533191,107.5419248
PAMEUNGPEUK,170,2818,1118,388,4324,85,379,1006,1470,5794,-7.018640407,107.5873088
KATAPANG,180,3603,1213,348,5164,164,559,1358,2081,7245,-7.003818095,107.5603805
SOREANG,190,3505,1075,326,4906,152,604,1193,1949,6855,-7.040885206,107.5188411
KUTAWARINGIN,191,4121,954,289,5364,291,1064,1569,2924,8288,-6.999693119,107.5098189
MARGAASIH,250,4052,996,275,5323,257,983,1558,2798,8121,-6.948775549,107.5445574
MARGAHAYU,260,1593,525,189,2307,80,189,527,796,3103,-6.975171703,107.5745209
DAYEUHKOLOT,270,2314,992,459,3765,212,282,731,1225,4990,-6.972753851,107.6131138
BOJONGSOANG,280,3179,1233,515,4927,157,363,947,1467,6394,-6.983735788,107.6645908
CILEUNYI,290,3154,1362,693,5209,222,393,1020,1635,6844,-6.93282003,107.7390658
CILENGKRANG,300,1697,486,162,2345,136,331,582,1049,3394,-6.862587349,107.723253
CIMENYAN,310,3731,1186,490,5407,307,581,1151,2039,7446,-6.862367611,107.6694346
CISEWU,10,1542,551,151,2244,73,268,576,917,3161,-7.377565335,107.5232221
CARINGIN,11,1589,465,123,2177,76,190,451,717,2894,-7.464339106,107.4959387
TALEGONG,20,1537,440,134,2111,90,320,522,932,3043,-7.292861207,107.5248085
BUNGBULANG,30,3133,937,230,4300,106,439,759,1304,5604,-7.436011135,107.5898124
MEKARMUKTI,31,1203,407,74,1684,49,167,363,579,2263,-7.527898655,107.5629613
PAMULIHAN,40,1567,433,90,2090,52,261,490,803,2893,-7.363302753,107.6820042
PAKENJENG,50,5642,1780,506,7928,272,796,1464,2532,10460,-7.469250625,107.686442
CIKELET,60,3180,1118,332,4630,142,357,867,1366,5996,-7.553101854,107.6964414
PAMEUNGPEUK,70,2319,847,301,3467,85,233,521,839,4306,-7.628349463,107.7310491
CIBALONG,80,2713,521,132,3366,247,763,927,1937,5303,-7.662188206,107.8510307
CISOMPET,90,4315,1409,341,6065,265,835,1347,2447,8512,-7.555221602,107.8080107
PEUNDEUY,100,2422,1107,427,3956,70,188,645,903,4859,-7.548711389,107.9090682
SINGAJAYA,110,4275,1251,226,5752,133,790,1255,2178,7930,-7.478086791,107.9174954
CIHURIP,111,1315,495,89,1899,50,247,478,775,2674,-7.506529667,107.8472372
CIKAJANG,120,4609,1236,317,6162,235,1105,1581,2921,9083,-7.400002142,107.8003372
BANJARWANGI,130,5977,1543,239,7759,274,1368,2048,3690,11449,-7.405645692,107.8825084
CILAWU,140,6246,2337,740,9323,457,1032,1978,3467,12790,-7.299960187,107.8994038
BAYONGBONG,150,6553,1813,512,8878,307,1389,2311,4007,12885,-7.274045977,107.8444307
CIGEDUG,151,2693,483,103,3279,290,777,1046,2113,5392,-7.32847429,107.8250471
CISURUPAN,160,6240,1934,570,8744,272,1060,1889,3221,11965,-7.305239498,107.7665289
SUKARESMI,161,2350,610,157,3117,105,473,718,1296,4413,-7.245847337,107.7710951
SAMARANG,170,4302,1307,384,5993,250,997,1496,2743,8736,-7.188194457,107.8125268
PASIRWANGI,171,3498,840,184,4522,248,879,1310,2437,6959,-7.211583561,107.7642334
TAROGONG KIDUL,181,4383,1574,495,6452,216,599,1327,2142,8594,-7.21510636,107.8837691
TAROGONG KALER,182,4067,1548,584,6199,192,546,1172,1910,8109,-7.174254579,107.861912
GARUT KOTA,190,5689,1845,624,8158,305,935,1801,3041,11199,-7.245185303,107.9265934
KARANGPAWITAN,200,6763,2594,879,10236,191,646,1903,2740,12976,-7.220939237,107.9541696
WANARAJA,210,2347,801,251,3399,122,334,678,1134,4533,-7.188690125,108.0083611
SUCINARAJA,211,1522,424,92,2038,85,331,466,882,2920,-7.216788032,108.0065536
PANGATIKAN,212,2547,885,303,3735,200,409,851,1460,5195,-7.176317866,108.0237909
SUKAWENING,220,3494,1194,347,5035,77,380,917,1374,6409,-7.135663601,108.0152944
KARANGTENGAH,221,1503,527,198,2228,19,91,248,358,2586,-7.157732163,108.0555227
BANYURESMI,230,5669,2154,747,8570,127,617,1788,2532,11102,-7.15131776,107.9342367
LELES,240,4004,1088,306,5398,208,900,1374,2482,7880,-7.113049556,107.8648699
LEUWIGOONG,250,2879,1017,320,4216,71,365,890,1326,5542,-7.109406622,107.9434475
CIBATU,260,5636,2145,812,8593,154,594,1437,2185,10778,-7.085379352,107.9984143
KERSAMANAH,261,2749,951,328,4028,67,326,778,1171,5199,-7.070771369,108.0316338
CIBIUK,270,1867,692,181,2740,33,182,553,768,3508,-7.064163603,107.9552972
KADUNGORA,280,4613,1876,771,7260,135,453,1340,1928,9188,-7.073862745,107.8950184
BLUBUR LIMBANGAN,290,6257,2012,749,9018,219,736,1611,2566,11584,-7.00547885,107.9518516
SELAAWI,300,3291,1179,356,4826,66,253,829,1148,5974,-7.000597668,108.0111241
MALANGBONG,310,9177,2762,590,12529,386,1733,3134,5253,17782,-7.057158598,108.082022
CIPATUJAH,10,3126,1017,315,4458,248,563,958,1769,6227,-7.702406318,108.0266451
KARANGNUNGGAL,20,2836,893,244,3973,200,493,950,1643,5616,-7.663733861,108.1506633
CIKALONG,30,2601,803,234,3638,79,276,635,990,4628,-7.750615394,108.2153724
PANCATENGAH,40,2325,759,216,3300,160,342,698,1200,4500,-7.689097688,108.3029178
CIKATOMAS,50,2093,784,182,3059,141,271,597,1009,4068,-7.618204097,108.2688537
CIBALONG,60,1245,460,124,1829,49,146,395,590,2419,-7.566618357,108.1895762
PARUNGPONTENG,61,1661,629,172,2462,65,168,519,752,3214,-7.495644293,108.1399499
BANTARKALONG,70,1266,478,138,1882,94,164,409,667,2549,-7.57916684,108.0810476
BOJONGASIH,71,854,316,63,1233,38,95,238,371,1604,-7.555032601,108.1284398
CULAMEGA,72,1128,386,99,1613,141,246,353,740,2353,-7.599238867,108.0301756
BOJONGGAMBIR,80,2901,946,272,4119,125,484,837,1446,5565,-7.570333012,107.9632603
SODONGHILIR,90,3932,1576,449,5957,205,459,1149,1813,7770,-7.493048511,108.0538632
TARAJU,100,2151,541,107,2799,137,476,667,1280,4079,-7.444244329,107.9925341
SALAWU,110,2476,700,224,3400,227,546,850,1623,5023,-7.372841529,107.9842392
PUSPAHIANG,111,1650,343,52,2045,95,324,550,969,3014,-7.418877205,108.0359847
TANJUNGJAYA,120,2648,827,230,3705,180,490,890,1560,5265,-7.412787381,108.1245226
SUKARAJA,130,3108,815,187,4110,191,614,1022,1827,5937,-7.442696456,108.1662849
SALOPA,140,3532,1220,399,5151,257,520,1070,1847,6998,-7.503925849,108.2884143
JATIWARAS,141,3008,1015,311,4334,176,492,972,1640,5974,-7.498153447,108.2253743
CINEAM,150,994,389,116,1499,79,151,307,537,2036,-7.419612017,108.3630277
KARANGJAYA,151,453,175,40,668,23,69,159,251,919,-7.448947645,108.3948013
MANONJAYA,160,2432,815,254,3501,189,373,760,1322,4823,-7.370119658,108.3202316
GUNUNGTANJUNG,161,1423,339,86,1848,131,369,481,981,2829,-7.427103446,108.3028045
SINGAPARNA,190,2317,933,321,3571,66,258,659,983,4554,-7.349446249,108.1287925
SUKARAME,191,1646,513,187,2346,117,342,559,1018,3364,-7.373755369,108.1488925
MANGUNREJA,192,1696,521,158,2375,96,285,506,887,3262,-7.382445612,108.0834821
CIGALONTANG,200,3527,1124,287,4938,413,731,1287,2431,7369,-7.307236152,108.0052583
LEUWISARI,210,1672,665,238,2575,55,170,455,680,3255,-7.303530295,108.090933
SARIWANGI,211,2081,974,384,3439,60,160,553,773,4212,-7.293546936,108.0572465
PADAKEMBANG,212,1346,436,164,1946,95,208,416,719,2665,-7.309138069,108.1220545
SUKARATU,221,1738,620,255,2613,118,286,561,965,3578,-7.275427312,108.1240425
CISAYONG,230,1960,683,178,2821,91,359,673,1123,3944,-7.243287486,108.1339147
SUKAHENING,231,1403,474,120,1997,69,205,472,746,2743,-7.21136212,108.1175491
RAJAPOLAH,240,2027,700,204,2931,109,285,683,1077,4008,-7.216679766,108.1830482
JAMANIS,250,2002,702,198,2902,86,279,667,1032,3934,-7.187598361,108.1627735
CIAWI,260,2908,954,250,4112,117,517,916,1550,5662,-7.168254606,108.1159833
KADIPATEN,261,2271,463,110,2844,133,685,880,1698,4542,-7.119107916,108.1161013
PAGERAGEUNG,270,2121,586,123,2830,98,511,769,1378,4208,-7.099850315,108.1748724
SUKARESIK,271,2091,721,166,2978,96,280,742,1118,4096,-7.156792858,108.1825966
CIMERAK,10,1573,446,95,2114,118,270,537,925,3039,-7.762714124,108.391929
CIJULANG,20,608,234,86,928,26,73,131,230,1158,-7.715580043,108.4435977
CIGUGUR,30,1089,391,133,1613,56,146,272,474,2087,-7.623624997,108.4018896
LANGKAPLANCAR,40,2709,977,196,3882,95,351,813,1259,5141,-7.551860469,108.4369413
PARIGI,50,1181,445,121,1747,63,145,340,548,2295,-7.64822606,108.5176205
SIDAMULIH,60,468,170,53,691,30,89,164,283,974,-7.62043004,108.5890547
PANGANDARAN,70,1267,494,157,1918,53,222,440,715,2633,-7.647625308,108.6513205
KALIPUCANG,80,900,326,80,1306,45,155,283,483,1789,-7.638803384,108.7175604
PADAHERANG,90,2352,816,251,3419,116,333,708,1157,4576,-7.550835173,108.694164
MANGUNJAYA,91,1172,355,70,1597,51,194,417,662,2259,-7.485116238,108.6892114
BANJARSARI,100,4269,1533,419,6221,206,698,1500,2404,8625,-7.512136269,108.5754386
LAKBOK,110,2117,865,277,3259,91,246,589,926,4185,-7.405699453,108.6627073
PURWADADI,111,1632,546,157,2335,78,266,571,915,3250,-7.439871047,108.6413511
PAMARICAN,120,2457,913,245,3615,133,390,749,1272,4887,-7.455982032,108.5144419
CIDOLOG,130,885,355,85,1325,66,109,278,453,1778,-7.427139484,108.4411267
CIMARAGAS,140,465,212,72,749,46,63,143,252,1001,-7.379876842,108.447495
CIJEUNGJING,150,1570,613,250,2433,77,162,342,581,3014,-7.332153196,108.4193383
CISAGA,160,1100,417,157,1674,111,144,327,582,2256,-7.316364958,108.5088614
TAMBAKSARI,170,581,223,57,861,26,99,225,350,1211,-7.238833254,108.5488766
RANCAH,180,1707,729,150,2586,104,274,670,1048,3634,-7.205179395,108.4955523
RAJADESA,190,1818,717,162,2697,109,317,630,1056,3753,-7.173086499,108.4509404
SUKADANA,200,775,361,139,1275,17,64,172,253,1528,-7.272762367,108.4518005
CIAMIS,210,2871,1117,428,4416,145,277,753,1175,5591,-7.329779981,108.3374082
BAREGBEG,211,1691,549,150,2390,91,214,509,814,3204,-7.289602581,108.3713518
CIKONENG,220,2714,927,325,3966,131,435,808,1374,5340,-7.280302528,108.27436
SINDANGKASIH,221,2255,718,241,3214,73,336,730,1139,4353,-7.283407044,108.2382911
CIHAURBEUTI,230,2541,964,300,3805,74,380,762,1216,5021,-7.221687292,108.2303463
SADANANYA,240,1706,587,129,2422,64,300,539,903,3325,-7.255194564,108.3073575
CIPAKU,250,2598,930,257,3785,119,354,855,1328,5113,-7.235802136,108.3618595
JATINAGARA,260,1222,327,40,1589,42,284,525,851,2440,-7.182360011,108.4051951
PANAWANGAN,270,1505,577,141,2223,86,261,516,863,3086,-7.108769029,108.3826793
KAWALI,280,1512,522,159,2193,55,233,487,775,2968,-7.175479884,108.3587239
LUMBUNG,281,1227,477,159,1863,62,137,387,586,2449,-7.152763413,108.3257293
PANJALU,290,2285,754,242,3281,124,452,815,1391,4672,-7.138308866,108.2783238
SUKAMANTRI,291,1064,286,46,1396,86,247,327,660,2056,-7.078372816,108.2894163
PANUMBANGAN,300,3261,1101,342,4704,180,632,1139,1951,6655,-7.135579902,108.2247242
DARMA,10,3216,1248,413,4877,101,368,963,1432,6309,-7.00966235,108.4032464
KADUGEDE,20,1050,409,147,1606,59,97,219,375,1981,-7.008064821,108.4521547
NUSAHERANG,21,1029,447,164,1640,9,79,241,329,1969,-7.015018529,108.4320322
CINIRU,30,774,233,66,1073,25,81,189,295,1368,-7.057134886,108.505906
HANTARA,31,561,250,114,925,35,35,117,187,1112,-7.064352477,108.4537899
SELAJAMBE,40,794,282,88,1164,37,75,189,301,1465,-7.104273966,108.4681247
SUBANG,50,805,379,144,1328,33,74,195,302,1630,-7.128800313,108.5385696
CILEBAK,51,472,238,75,785,24,51,148,223,1008,-7.139801362,108.577592
CIWARU,60,1694,556,172,2422,98,268,540,906,3328,-7.086505631,108.6317728
KARANGKANCANA,61,1212,304,75,1591,109,338,456,903,2494,-7.101370483,108.6726957
CIBINGBIN,70,1632,679,237,2548,221,305,651,1177,3725,-7.054783548,108.757098
CIBEUREUM,71,856,379,83,1318,50,145,292,487,1805,-7.07895793,108.7153842
LURAGUNG,80,1735,588,190,2513,97,289,558,944,3457,-7.019385192,108.6302267
CIMAHI,81,1643,486,106,2235,140,399,672,1211,3446,-7.000612496,108.6986109
CIDAHU,90,2608,725,188,3521,183,663,1227,2073,5594,-6.964025245,108.6614802
KALIMANGGIS,91,1591,424,98,2113,96,354,628,1078,3191,-6.95275881,108.6267223
CIAWIGEBANG,100,5130,1690,453,7273,240,860,1801,2901,10174,-6.946913412,108.599554
CIPICUNG,101,1034,405,91,1530,42,219,497,758,2288,-6.941640993,108.551618
LEBAKWANGI,110,2144,720,208,3072,115,349,784,1248,4320,-7.01006603,108.5855988
MALEBER,111,2709,954,293,3956,125,483,892,1500,5456,-7.056143889,108.5721031
GARAWANGI,120,2363,855,300,3518,115,315,819,1249,4767,-7.013419634,108.5269506
SIDANGAGUNG,121,2018,746,258,3022,73,264,620,957,3979,-6.971438958,108.531394
KUNINGAN,130,3460,1378,559,5397,119,341,937,1397,6794,-6.981114474,108.4912558
CIGUGUR,140,1682,604,265,2551,42,111,292,445,2996,-6.954288007,108.440648
KRAMAT MULYA,150,2162,957,376,3495,35,125,592,752,4247,-6.941372592,108.4933337
JALAKSANA,160,1078,422,137,1637,43,158,392,593,2230,-6.915807783,108.458896
JAPARA,161,787,311,67,1165,58,154,324,536,1701,-6.911631188,108.5436788
CILIMUS,170,1755,767,298,2820,27,94,405,526,3346,-6.876253438,108.4726058
CIGANDAMEKAR,171,1767,649,198,2614,46,166,532,744,3358,-6.887353828,108.5309316
MANDIRANCAN,180,1236,572,257,2065,10,55,283,348,2413,-6.844953283,108.4545708
PANCALANG,181,1361,572,253,2186,35,78,324,437,2623,-6.817072713,108.4947439
PASAWAHAN,190,1120,475,187,1782,13,48,303,364,2146,-6.824986172,108.4270284
WALED,10,3598,1013,343,4954,269,865,1614,2748,7702,-6.909759747,108.685398
PASALEMAN,11,1558,498,164,2220,109,262,605,976,3196,-6.953960445,108.7367254
CILEDUG,20,2663,1066,387,4116,146,410,822,1378,5494,-6.898093503,108.7474726
PABUARAN,21,2085,753,232,3070,140,296,771,1207,4277,-6.894411259,108.7208125
LOSARI,30,4294,1837,781,6912,226,660,1809,2695,9607,-6.805763709,108.8060683
PABEDILAN,31,3017,1071,359,4447,217,657,1306,2180,6627,-6.861651124,108.7703399
BABAKAN,40,3385,1421,524,5330,183,517,1381,2081,7411,-6.866118277,108.7166926
GEBANG,41,3505,1308,343,5156,284,787,1524,2595,7751,-6.829384807,108.7330681
KARANGSEMBUNG,50,2281,841,386,3508,154,328,798,1280,4788,-6.843457259,108.6645318
KARANGWARENG,51,1621,546,172,2339,70,334,591,995,3334,-6.883428219,108.6489513
LEMAHABANG,60,2472,1085,400,3957,135,335,912,1382,5339,-6.83407823,108.6151474
SUSUKANLEBAK,61,2343,766,296,3405,159,448,904,1511,4916,-6.862801035,108.6178429
SEDONG,70,1960,692,200,2852,90,309,809,1208,4060,-6.871811879,108.5744137
ASTANAJAPURA,80,5728,2154,910,8792,307,975,2327,3609,12401,-6.803714379,108.6214775
PANGENAN,81,2159,834,227,3220,169,412,984,1565,4785,-6.796057767,108.6664917
MUNDU,90,4291,1368,545,6204,695,1243,2025,3963,10167,-6.775089661,108.5811508
BEBER,100,2738,986,325,4049,267,557,1043,1867,5916,-6.825018243,108.5242794
GREGED,101,3820,1244,359,5423,382,1059,1819,3260,8683,-6.815762987,108.5615314
TALUN,111,3269,1235,535,5039,458,797,1483,2738,7777,-6.768418002,108.5093016
SUMBER,120,4221,1857,1005,7083,361,637,1508,2506,9589,-6.761931705,108.479059
DUKUPUNTANG,121,3921,1719,819,6459,257,501,1294,2052,8511,-6.760300893,108.4090792
PALIMANAN,130,3289,1563,755,5607,177,408,1108,1693,7300,-6.71181921,108.4272715
PLUMBON,140,3607,1736,984,6327,137,332,1160,1629,7956,-6.706001556,108.4770378
DEPOK,141,3725,1615,708,6048,141,404,1258,1803,7851,-6.735540829,108.4468097
WERU,150,3494,1635,982,6111,331,506,1235,2072,8183,-6.717260744,108.4962283
PLERED,151,2686,1113,527,4326,172,399,1000,1571,5897,-6.681935832,108.505038
TENGAH TANI,161,2537,1108,536,4181,128,346,862,1336,5517,-6.699930199,108.5237693
KEDAWUNG,162,2205,1065,541,3811,116,215,718,1049,4860,-6.716433348,108.5333024
GUNUNGJATI,171,2376,1232,652,4260,91,238,890,1219,5479,-6.665599975,108.5356348
KAPETAKAN,180,3890,1611,547,6048,199,715,1645,2559,8607,-6.574287684,108.5139453
SURANENGGALA,181,1966,995,585,3546,142,227,634,1003,4549,-6.631624418,108.5230066
KLANGENAN,190,3240,1361,521,5122,169,533,1525,2227,7349,-6.667798508,108.4516114
JAMBLANG,191,2496,1039,454,3989,181,434,1013,1628,5617,-6.666097782,108.4752137
ARJAWINANGUN,200,2701,1371,724,4796,164,370,1011,1545,6341,-6.641584631,108.4083528
PANGURAGAN,201,2102,775,310,3187,148,558,1072,1778,4965,-6.617146232,108.4615028
CIWARINGIN,210,1250,642,380,2272,101,237,515,853,3125,-6.67597606,108.3823146
GEMPOL,211,3091,1509,725,5325,172,405,1157,1734,7059,-6.706724483,108.3974558
SUSUKAN,220,2922,1164,437,4523,320,739,1460,2519,7042,-6.625311076,108.359502
GEGESIK,230,3070,1253,423,4746,91,451,1180,1722,6468,-6.574306318,108.429692
KALIWEDI,231,2244,1060,499,3803,353,470,982,1805,5608,-6.580339891,108.388521
LEMAHSUGIH,10,3982,1383,494,5859,193,461,1081,1735,7594,-7.008848001,108.1894896
BANTARUJEG,20,2355,742,248,3345,109,288,719,1116,4461,-6.964148759,108.2514006
MALAUSMA,21,3915,1284,329,5528,188,744,1364,2296,7824,-7.039011554,108.2438405
CIKIJING,30,3407,1232,334,4973,81,438,963,1482,6455,-7.005458325,108.3659701
CINGAMBUL,31,2716,891,223,3830,164,547,971,1682,5512,-7.042551249,108.330253
TALAGA,40,1911,638,187,2736,79,306,598,983,3719,-6.988694381,108.3183416
BANJARAN,41,737,299,94,1130,19,76,207,302,1432,-6.954249056,108.3345731
ARGAPURA,50,1198,304,64,1566,100,307,476,883,2449,-6.89755658,108.3535986
MAJA,60,2138,764,278,3180,62,276,594,932,4112,-6.902796046,108.2754606
MAJALENGKA,70,1970,750,290,3010,64,236,550,850,3860,-6.856572183,108.2258548
CIGASONG,80,1377,486,149,2012,37,149,374,560,2572,-6.81869852,108.2556929
SUKAHAJI,90,1274,488,133,1895,57,165,362,584,2479,-6.813572561,108.2960892
SINDANG,91,719,245,72,1036,21,91,221,333,1369,-6.835116906,108.3270288
RAJAGALUH,100,1470,538,146,2154,49,264,491,804,2958,-6.824673739,108.3630366
SINDANGWANGI,110,1291,464,137,1892,40,182,476,698,2590,-6.80303443,108.3847442
LEUWIMUNDING,120,2204,834,244,3282,67,270,610,947,4229,-6.744309736,108.340953
PALASAH,130,1737,650,184,2571,53,210,455,718,3289,-6.738967495,108.2995983
JATIWANGI,140,3198,1134,385,4717,134,463,1004,1601,6318,-6.744871241,108.2602626
DAWUAN,150,1612,574,185,2371,52,191,462,705,3076,-6.725085602,108.2078881
KASOKANDEL,151,2087,613,172,2872,86,319,691,1096,3968,-6.773744392,108.2261131
PANYINGKIRAN,160,950,352,113,1415,33,99,278,410,1825,-6.812253799,108.1799965
KADIPATEN,170,1856,723,220,2799,56,193,533,782,3581,-6.759403851,108.1758788
KERTAJATI,180,996,356,113,1465,96,188,345,629,2094,-6.642727847,108.1311398
JATITUJUH,190,1066,469,147,1682,66,165,407,638,2320,-6.625268857,108.2300649
LIGUNG,200,1669,657,192,2518,54,245,540,839,3357,-6.662540915,108.2852961
SUMBERJAYA,210,2416,934,320,3670,93,358,825,1276,4946,-6.689756281,108.3315472
JATINANGOR,10,2055,886,334,3275,122,210,716,1048,4323,-6.931339472,107.7775991
CIMANGGUNG,20,3747,1395,447,5589,183,647,1335,2165,7754,-6.949197605,107.853124
TANJUNGSARI,30,2090,723,231,3044,92,285,763,1140,4184,-6.868041635,107.7969065
SUKASARI,31,1063,357,98,1518,132,258,471,861,2379,-6.864040816,107.7672294
PAMULIHAN,32,2590,777,173,3540,164,507,1011,1682,5222,-6.894441714,107.8469169
RANCAKALONG,40,989,341,79,1409,91,178,386,655,2064,-6.823475164,107.8408999
SUMEDANG SELATAN,50,1913,718,201,2832,72,226,670,968,3800,-6.901822454,107.9214381
SUMEDANG UTARA,60,2309,871,363,3543,69,279,675,1023,4566,-6.835981772,107.908162
GANEAS,61,949,365,85,1399,29,102,339,470,1869,-6.870392129,107.9679302
SITURAJA,70,1269,519,141,1929,21,124,373,518,2447,-6.864414373,108.0065061
CISITU,71,1204,532,154,1890,34,124,351,509,2399,-6.876253197,108.0399468
DARMARAJA,80,1325,540,172,2037,86,187,469,742,2779,-6.91203742,108.0618645
CIBUGEL,90,737,220,67,1024,75,180,260,515,1539,-6.966583334,108.0265598
WADO,100,2046,585,118,2749,99,417,785,1301,4050,-6.984352458,108.1171669
JATINUNGGAL,101,1695,530,118,2343,81,271,605,957,3300,-6.93553815,108.1634025
JATIGEDE,111,674,244,51,969,67,120,253,440,1409,-6.869618068,108.1342458
TOMO,120,671,238,61,970,25,90,236,351,1321,-6.78989007,108.1120733
UJUNG JAYA,130,970,427,125,1522,80,140,412,632,2154,-6.70927932,108.0929477
CONGGEANG,140,552,178,60,790,21,83,206,310,1100,-6.728528553,108.0207337
PASEH,150,630,270,71,971,41,102,249,392,1363,-6.796538227,108.013285
CIMALAKA,160,1350,488,154,1992,70,151,434,655,2647,-6.793243737,107.943546
CISARUA,161,602,196,42,840,23,111,257,391,1231,-6.831796746,107.9695702
TANJUNGKERTA,170,900,416,118,1434,49,122,358,529,1963,-6.761950163,107.9017295
TANJUNGMEDAR,171,767,220,57,1044,47,140,231,418,1462,-6.735862685,107.8622186
BUAHDUA,180,773,273,63,1109,29,122,289,440,1549,-6.686615086,107.9452533
SURIAN,181,357,109,19,485,24,63,137,224,709,-6.643033731,107.8753502
HAURGEULIS,10,6169,2318,929,9416,257,888,2099,3244,12660,-6.446405204,107.9374704
GANTAR,11,3535,1147,327,5009,179,580,1204,1963,6972,-6.546262429,107.949854
KROYA,20,3535,1196,355,5086,383,694,1351,2428,7514,-6.499858456,108.0409925
GABUSWETAN,30,3158,1161,448,4767,213,424,1003,1640,6407,-6.427560245,108.068107
CIKEDUNG,40,1790,628,216,2634,114,232,650,996,3630,-6.537107111,108.1748578
TERISI,41,2976,1042,370,4388,149,443,982,1574,5962,-6.560595519,108.0672648
LELEA,50,2185,861,280,3326,119,339,765,1223,4549,-6.461086727,108.2255462
BANGODUA,60,1193,512,173,1878,116,180,521,817,2695,-6.516956265,108.2788159
TUKDANA,61,2341,938,303,3582,111,303,920,1334,4916,-6.56128489,108.2729177
WIDASARI,70,1623,699,338,2660,80,219,565,864,3524,-6.466611341,108.2732642
KERTASEMAYA,80,3006,1468,680,5154,139,324,999,1462,6616,-6.519213359,108.3673122
SUKAGUMIWANG,81,1297,654,174,2125,101,263,632,996,3121,-6.581862143,108.3236726
KRANGKENG,90,4145,1558,628,6331,248,821,1667,2736,9067,-6.515526375,108.4866116
KARANGAMPEL,100,3494,1550,628,5672,94,420,1190,1704,7376,-6.470686069,108.4526912
KEDOKAN BUNDER,101,2200,981,352,3533,124,298,844,1266,4799,-6.498111123,108.4135415
JUNTINYUAT,110,3417,1417,521,5355,267,605,1522,2394,7749,-6.435703162,108.4106232
SLIYEG,120,2495,1009,408,3912,145,424,1013,1582,5494,-6.450148759,108.3486042
JATIBARANG,130,3193,1477,677,5347,137,303,1076,1516,6863,-6.440432196,108.3127633
BALONGAN,140,2051,802,301,3154,130,346,844,1320,4474,-6.384045751,108.3754618
INDRAMAYU,150,5458,2195,897,8550,226,654,1785,2665,11215,-6.346221825,108.3396728
SINDANG,160,1940,755,291,2986,169,346,755,1270,4256,-6.331952138,108.2974197
CANTIGI,161,1947,802,254,3003,83,239,581,903,3906,-6.298060701,108.2387776
PASEKAN,162,1800,647,298,2745,149,313,586,1048,3793,-6.27442633,108.3044704
LOHBENER,170,2409,1070,434,3913,141,264,812,1217,5130,-6.399805737,108.2562567
ARAHAN,171,1405,600,269,2274,106,190,431,727,3001,-6.363312039,108.2467327
LOSARANG,180,2544,1072,428,4044,123,303,932,1358,5402,-6.370968132,108.1748967
KANDANGHAUR,190,5038,1820,745,7603,386,767,1757,2910,10513,-6.35615414,108.092554
BONGAS,200,2691,1178,411,4280,167,282,880,1329,5609,-6.379961589,108.0174881
ANJATAN,210,4025,1503,538,6066,227,520,1207,1954,8020,-6.376435397,107.94652
SUKRA,220,2380,867,377,3624,182,356,745,1283,4907,-6.291060943,107.9480261
PATROL,221,3156,1103,482,4741,154,385,916,1455,6196,-6.319597489,108.0012016
SAGALAHERANG,10,958,381,126,1465,100,168,320,588,2053,-6.684030843,107.645749
SERANGPANJANG,11,820,321,143,1284,76,79,204,359,1643,-6.646856065,107.6116001
JALANCAGAK,20,1702,658,245,2605,43,140,404,587,3192,-6.668265221,107.7007863
CIATER,21,559,204,52,815,32,84,183,299,1114,-6.737311201,107.6699503
CISALAK,30,1994,807,274,3075,105,262,603,970,4045,-6.761015002,107.7472353
KASOMALANG,31,1673,650,229,2552,103,177,514,794,3346,-6.69436718,107.7532958
TANJUNGSIANG,40,1690,550,198,2438,72,178,501,751,3189,-6.743481157,107.8133747
CIJAMBE,50,1391,620,230,2241,113,176,420,709,2950,-6.631018063,107.7758032
CIBOGO,60,1152,478,172,1802,55,109,310,474,2276,-6.568184634,107.8379878
SUBANG,70,4534,1927,881,7342,247,393,1282,1922,9264,-6.574021319,107.778263
KALIJATI,80,1731,748,257,2736,113,211,512,836,3572,-6.527443359,107.6499466
DAWUAN,81,1367,563,182,2112,141,183,515,839,2951,-6.574456629,107.686506
CIPEUNDEUY,90,1163,453,157,1773,102,160,416,678,2451,-6.498985022,107.5945891
PABUARAN,100,3179,1314,397,4890,146,380,1063,1589,6479,-6.421300238,107.5942126
PATOKBEUSI,110,4012,1499,487,5998,278,571,1293,2142,8140,-6.367939613,107.6163364
PURWADADI,120,1971,863,457,3291,164,212,550,926,4217,-6.443371696,107.686285
CIKAUM,130,1912,723,210,2845,138,297,692,1127,3972,-6.413809701,107.7371263
PAGADEN,140,2419,939,429,3787,232,269,669,1170,4957,-6.480692295,107.8002688
PAGADEN BARAT,141,1035,508,185,1728,95,103,279,477,2205,-6.485516091,107.7672695
CIPUNAGARA,150,2572,975,276,3823,180,404,1064,1648,5471,-6.488959999,107.8638747
COMPRENG,160,1957,841,308,3106,177,277,676,1130,4236,-6.387136874,107.8743954
BINONG,170,1838,775,273,2886,118,256,716,1090,3976,-6.400387526,107.8003748
TAMBAKDAHAN,171,1608,604,173,2385,145,351,702,1198,3583,-6.342479388,107.8111088
CIASEM,180,5204,1994,681,7879,296,674,1886,2856,10735,-6.320133819,107.6611905
PAMANUKAN,190,3125,1107,311,4543,187,494,1074,1755,6298,-6.291537128,107.8224553
SUKASARI,191,1911,679,235,2825,118,271,621,1010,3835,-6.289645124,107.7568373
PUSAKANAGARA,200,2148,730,229,3107,164,474,840,1478,4585,-6.253174109,107.8757681
PUSAKAJAYA,201,1581,569,206,2356,183,316,602,1101,3457,-6.311217371,107.8923778
LEGONKULON,210,1161,397,126,1684,67,204,442,713,2397,-6.232304696,107.8068716
BLANAKAN,220,3698,1169,377,5244,321,690,1343,2354,7598,-6.26375585,107.6653803
JATILUHUR,10,1341,609,231,2181,140,180,490,810,2991,-6.559958258,107.421786
SUKASARI,11,792,272,81,1145,45,153,311,509,1654,,
MANIIS,20,1730,485,270,2485,225,335,455,1015,3500,-6.681362116,107.2987105
TEGAL WARU,30,2637,871,330,3838,195,522,1030,1747,5585,-6.627803854,107.3344179
PLERED,40,2877,1000,380,4257,180,559,1119,1858,6115,-6.645751814,107.3797174
SUKATANI,50,2728,759,195,3682,280,766,1142,2188,5870,-6.597976966,107.3917759
DARANGDAN,60,2587,725,163,3475,161,499,993,1653,5128,-6.687183606,107.4443825
BOJONG,70,2303,460,179,2942,332,711,862,1905,4847,-6.703674347,107.5179044
WANAYASA,80,1660,489,131,2280,119,385,644,1148,3428,-6.671188465,107.5464122
KIARAPEDES,81,825,369,102,1296,66,115,295,476,1772,-6.634535206,107.5665169
PASAWAHAN,90,967,399,169,1535,48,149,400,597,2132,-6.574728095,107.4790247
PONDOK SALAM,91,926,388,96,1410,106,226,452,784,2194,-6.619751964,107.4913693
PURWAKARTA,100,1831,807,389,3027,80,151,530,761,3788,-6.54009792,107.4548248
BABAKANCIKAO,101,870,362,148,1380,64,108,352,524,1904,-6.490833414,107.4241264
CAMPAKA,110,738,259,113,1110,57,144,348,549,1659,-6.487628575,107.5086691
CIBATU,111,616,244,89,949,69,102,259,430,1379,-6.532284886,107.5368535
BUNGURSARI,112,587,225,100,912,41,71,223,335,1247,-6.456110185,107.4769384
PANGKALAN,10,1330,482,159,1971,63,151,399,613,2584,-6.463376345,107.2280827
TEGALWARU,11,1367,448,190,2005,70,141,386,597,2602,-6.522021345,107.2429723
CIAMPEL,20,1716,632,181,2529,94,259,670,1023,3552,-6.430005015,107.3329291
TELUKJAMBE TIMUR,31,2018,755,435,3208,165,234,601,1000,4208,-6.341334217,107.2894058
TELUKJAMBE BARAT,32,1946,745,360,3051,152,265,763,1180,4231,-6.357420174,107.2455925
KLARI,40,3237,1250,683,5170,208,295,967,1470,6640,-6.395122909,107.3803432
CIKAMPEK,50,2743,1009,409,4161,167,275,809,1251,5412,-6.413714006,107.4365302
PURWASARI,51,2152,761,252,3165,51,219,645,915,4080,-6.369515734,107.4095183
TIRTAMULYA,60,2587,900,373,3860,146,297,858,1301,5161,-6.340814468,107.4624829
JATISARI,70,3652,1450,539,5641,168,366,1208,1742,7383,-6.355807277,107.522137
BANYUSARI,71,2517,921,264,3702,155,433,1132,1720,5422,-6.302627348,107.539919
KOTABARU,72,3158,1064,401,4623,108,361,1014,1483,6106,-6.396385477,107.4873619
CILAMAYA WETAN,81,3893,1335,512,5740,310,581,1358,2249,7989,-6.22723708,107.5783924
CILAMAYA KULON,82,3645,1240,388,5273,132,493,1257,1882,7155,-6.218571998,107.5152702
LEMAHABANG,90,3059,1042,367,4468,283,547,1158,1988,6456,-6.283847265,107.4566338
TALAGASARI,100,2817,1020,361,4198,116,335,864,1315,5513,-6.271072888,107.4138814
MAJALAYA,111,1576,543,195,2314,114,270,588,972,3286,-6.305800114,107.3682711
KARAWANG TIMUR,112,3259,1300,508,5067,189,376,1152,1717,6784,-6.299805814,107.3331691
KARAWANG BARAT,113,5876,2097,877,8850,305,762,2020,3087,11937,-6.273018692,107.2960261
RAWAMERTA,120,2359,876,248,3483,125,330,870,1325,4808,-6.23441306,107.3518574
TEMPURAN,130,3222,1027,269,4518,177,608,1257,2042,6560,-6.196427841,107.4437179
KUTAWALUYA,140,3325,1257,374,4956,191,563,1478,2232,7188,-6.17435891,107.3462002
RENGASDENGKLOK,150,5912,1997,728,8637,411,920,2129,3460,12097,-6.176220865,107.3016098
JAYAKERTA,151,3913,1375,320,5608,149,634,1685,2468,8076,-6.104998832,107.2974715
PEDES,160,4659,1539,490,6688,324,862,1861,3047,9735,-6.090847575,107.371932
CILEBAR,161,2631,1054,276,3961,112,355,1056,1523,5484,-6.132999557,107.4132351
CIBUAYA,170,3409,1127,499,5035,441,532,1196,2169,7204,-6.01599795,107.3283291
TIRTAJAYA,180,3656,1084,281,5021,328,891,1557,2776,7797,-6.029462927,107.2533011
BATUJAYA,190,5221,1612,458,7291,173,679,1744,2596,9887,-6.051078083,107.1952604
PAKISJAYA,200,2853,893,337,4083,170,384,901,1455,5538,-6.005285722,107.1256103
SETU,10,2384,1087,477,3948,157,309,1065,1531,5479,-6.363520234,107.0377415
SERANG BARU,21,2079,922,327,3328,194,313,729,1236,4564,-6.396403471,107.1144533
CIKARANG PUSAT,22,805,316,93,1214,22,113,288,423,1637,-6.359696047,107.1837138
CIKARANG SELATAN,23,450,161,64,675,36,60,167,263,938,-6.338469596,107.1285926
CIBARUSAH,30,1196,554,224,1974,90,244,589,923,2897,-6.435449598,107.1094602
BOJONGMANGU,31,840,362,187,1389,123,120,269,512,1901,-6.43824583,107.1792166
CIKARANG TIMUR,41,2666,1033,454,4153,209,403,991,1603,5756,-6.288219608,107.2094018
KEDUNGWARINGIN,50,2408,881,282,3571,226,384,929,1539,5110,-6.250873707,107.2483549
CIKARANG UTARA,61,1174,480,186,1840,198,262,566,1026,2866,-6.275284087,107.1555408
KARANGBAHAGIA,62,3338,1188,336,4862,128,532,1339,1999,6861,-6.21762403,107.1969276
CIBITUNG,70,1635,575,243,2453,263,369,718,1350,3803,-6.234693264,107.100834
CIKARANG BARAT,71,1332,554,235,2121,69,197,539,805,2926,-6.296659487,107.0942503
TAMBUN SELATAN,81,798,352,175,1325,54,124,346,524,1849,-6.256546332,107.0553607
TAMBUN UTARA,82,2596,1073,446,4115,330,458,1080,1868,5983,-6.192349595,107.0609474
BABELAN,90,4089,1758,915,6762,564,627,1480,2671,9433,-6.125705402,107.0344069
TARUMAJAYA,100,2425,928,410,3763,127,308,831,1266,5029,-6.121952761,106.9975468
TAMBELANG,110,1677,744,355,2776,85,212,454,751,3527,-6.167851212,107.1273715
SUKAWANGI,111,2413,828,294,3535,143,322,789,1254,4789,-6.120520929,107.0925103
SUKATANI,120,3150,1238,450,4838,221,427,1076,1724,6562,-6.192543538,107.1555145
SUKAKARYA,121,2431,889,332,3652,154,448,909,1511,5163,-6.145556819,107.1856762
PEBAYURAN,130,5442,1574,489,7505,481,1362,2332,4175,11680,-6.15937163,107.2484094
CABANGBUNGIN,140,2320,1122,621,4063,252,189,676,1117,5180,-6.078844459,107.1368561
MUARA GEMBONG,150,2111,520,247,2878,240,601,841,1682,4560,-5.996071388,107.0499777
RONGGA,10,3099,860,255,4214,218,625,912,1755,5969,-6.969957227,107.2563598
GUNUNGHALU,20,2998,810,210,4018,238,649,1026,1913,5931,-7.042601853,107.3011608
SINDANGKERTA,30,3463,1168,418,5049,240,541,1124,1905,6954,-7.040242045,107.4010221
CILILIN,40,4764,1494,616,6874,452,890,1539,2881,9755,,
CIHAMPELAS,50,6433,2020,824,9277,454,1176,2112,3742,13019,,
CIPONGKOR,60,6173,2002,560,8735,313,1061,2120,3494,12229,,
BATUJAJAR,70,5224,1804,672,7700,349,672,1741,2762,10462,,
CIPATAT,80,6398,1710,472,8580,531,1394,2146,4071,12651,-6.828967114,107.3892441
PADALARANG,90,4635,1655,715,7005,475,797,1542,2814,9819,,
NGAMPRAH,100,4148,1466,748,6362,266,491,1196,1953,8315,-6.83678306,107.5114443
PARONGPONG,110,1808,499,183,2490,151,327,621,1099,3589,-6.799508188,107.5835483
LEMBANG,120,6328,1739,711,8778,427,1109,1896,3432,12210,-6.809335337,107.6479414
CISARUA,130,1737,337,113,2187,122,478,683,1283,3470,-6.801499305,107.5386908
CIKALONG WETAN,140,5626,1393,326,7345,413,1329,1830,3572,10917,-6.742831215,107.4459004
CIPEUNDEUY,150,4199,1118,299,5616,280,911,1391,2582,8198,,
BOGOR SELATAN,10,8412,3178,1202,12792,412,1210,2744,4366,17158,-6.644708922,106.8135506
BOGOR TIMUR,20,2925,1204,536,4665,127,375,895,1397,6062,-6.620481579,106.8264761
BOGOR UTARA,30,5099,2111,914,8124,282,557,1439,2278,10402,-6.570972011,106.819344
BOGOR TENGAH,40,3086,1267,554,4907,136,280,776,1192,6099,-6.593767796,106.7980996
BOGOR BARAT,50,6197,2557,1045,9799,261,515,1562,2338,12137,-6.573271749,106.7655424
TANAH SEREAL,60,5072,2040,945,8057,257,505,1425,2187,10244,-6.546404056,106.7853767
BAROS,10,1068,437,247,1752,59,119,343,521,2273,-6.959767023,106.9324255
LEMBURSITU,11,1124,462,223,1809,71,139,291,501,2310,-6.965237985,106.900123
CIBEUREUM,12,1654,595,243,2492,84,226,500,810,3302,-6.94138844,106.9481166
CITAMIANG,20,1649,670,304,2623,50,146,436,632,3255,-6.937251253,106.9309594
WARUDOYONG,30,2498,962,468,3928,104,219,628,951,4879,-6.930732638,106.9131183
GUNUNG PUYUH,40,1101,501,211,1813,33,76,293,402,2215,-6.90845825,106.9174655
CIKOLE,50,1679,664,313,2656,85,191,486,762,3418,-6.915228044,106.9393472
BANDUNG KULON,10,2687,917,375,3979,155,455,939,1549,5528,-6.931049904,107.5649917
BABAKAN CIPARAY,20,3085,931,392,4408,227,554,1117,1898,6306,-6.94353672,107.578429
BOJONGLOA KALER,30,3252,1362,579,5193,133,338,1025,1496,6689,-6.932841084,107.5895255
BOJONGLOA KIDUL,40,1662,604,289,2555,97,218,580,895,3450,-6.951550678,107.5978089
ASTANAANYAR,50,1013,465,264,1742,23,89,309,421,2163,-6.933670049,107.6016804
REGOL,60,1029,504,314,1847,44,43,227,314,2161,-6.939833263,107.6125212
LENGKONG,70,595,307,156,1058,22,46,171,239,1297,-6.933871214,107.6249252
BANDUNG KIDUL,80,913,395,215,1523,32,69,261,362,1885,-6.957652876,107.6312236
BUAHBATU,90,1133,467,232,1832,67,123,371,561,2393,-6.950181191,107.6560644
RANCASARI,100,521,184,79,784,34,62,186,282,1066,-6.954531439,107.6739122
GEDEBAGE,101,279,123,53,455,11,35,82,128,583,-6.953577778,107.6975437
CIBIRU,110,1499,584,296,2379,39,125,390,554,2933,-6.914455822,107.7231515
PANYILEUKAN,111,384,155,60,599,10,23,88,121,720,-6.932381112,107.7066664
UJUNG BERUNG,120,1644,687,358,2689,101,121,504,726,3415,-6.905482788,107.7055687
CINAMBO,121,306,144,67,517,9,32,100,141,658,-6.927863472,107.6917194
ARCAMANIK,130,774,353,189,1316,44,61,177,282,1598,-6.920298821,107.6771481
ANTAPANI,141,569,248,137,954,11,25,140,176,1130,-6.916857325,107.6611847
MANDALAJATI,142,1036,449,256,1741,89,111,326,526,2267,-6.897622814,107.6721789
KIARACONDONG,150,1997,941,484,3422,139,152,625,916,4338,-6.924979484,107.6501195
BATUNUNGGAL,160,1890,868,507,3265,59,122,576,757,4022,-6.925848664,107.6372163
SUMUR BANDUNG,170,278,144,89,511,5,11,81,97,608,-6.914908363,107.6152761
ANDIR,180,1603,729,424,2756,66,120,458,644,3400,-6.910821525,107.5803566
CICENDO,190,1200,578,345,2123,65,86,353,504,2627,-6.901474896,107.5836479
BANDUNG WETAN,200,239,109,61,409,11,16,62,89,498,-6.904808282,107.6171582
CIBEUNYING KIDUL,210,1191,606,318,2115,28,95,390,513,2628,-6.900718046,107.6454704
CIBEUNYING KALER,220,647,303,138,1088,30,57,210,297,1385,-6.888299506,107.6302748
COBLONG,230,1441,635,424,2500,46,74,373,493,2993,-6.884903373,107.6154865
SUKAJADI,240,1225,659,363,2247,49,64,361,474,2721,-6.888170003,107.5901518
SUKASARI,250,673,339,204,1216,7,35,127,169,1385,-6.866476009,107.5871089
CIDADAP,260,540,251,152,943,33,55,153,241,1184,-6.863215447,107.6076479
HARJAMUKTI,10,4666,1875,878,7419,431,749,1275,2455,9874,-6.761432153,108.5482559
LEMAHWUNGKUK,20,2630,1203,622,4455,137,213,697,1047,5502,-6.731910386,108.5760307
PEKALIPAN,30,1108,556,251,1915,38,62,286,386,2301,-6.723344943,108.5635488
KESAMBI,40,2107,1041,607,3755,69,127,483,679,4434,-6.733184138,108.5421927
KEJAKSAN,50,1403,646,356,2405,37,91,371,499,2904,-6.704345582,108.5561266
PONDOKGEDE,10,5296,2514,1334,9144,159,163,983,1305,10449,-6.268900892,106.9300827
JATISAMPURNA,11,1768,829,526,3123,89,125,446,660,3783,-6.364891964,106.9248119
PONDOKMELATI,12,2901,1265,760,4926,106,153,607,866,5792,-6.30992136,106.9282736
JATIASIH,20,4974,2214,1110,8298,107,305,1289,1701,9999,-6.30733872,106.9523907
BANTARGEBANG,30,2019,1064,551,3634,116,91,434,641,4275,-6.33892597,106.9913653
MUSTIKAJAYA,31,3587,1447,708,5742,145,300,1011,1456,7198,-6.307127064,107.0161908
BEKASI TIMUR,40,4057,1783,999,6839,77,168,854,1099,7938,-6.242045003,107.0191311
RAWALUMBU,41,3631,1600,884,6115,261,196,765,1222,7337,-6.281107951,106.9941482
BEKASI SELATAN,50,3312,1509,902,5723,358,234,802,1394,7117,-6.258056533,106.9776484
BEKASI BARAT,60,5486,2503,1478,9467,285,242,985,1512,10979,-6.233617281,106.9627885
MEDAN SATRIA,61,3008,1332,669,5009,117,161,799,1077,6086,-6.197577934,106.9822142
BEKASI UTARA,70,5075,2446,1366,8887,250,218,1157,1625,10512,-6.207365105,107.0060321
SAWANGAN,10,3278,1491,805,5574,144,265,851,1260,6834,-6.405123301,106.7640639
BOJONGSARI,11,2325,1017,444,3786,53,198,645,896,4682,-6.39435579,106.7376864
PANCORAN MAS,20,4699,1852,1014,7565,178,322,1024,1524,9089,-6.398606262,106.7998496
CIPAYUNG,21,3946,1653,867,6466,171,283,990,1444,7910,-6.429127357,106.8023034
SUKMA JAYA,30,2646,1120,583,4349,117,149,564,830,5179,-6.397202833,106.8436485
CILODONG,31,2208,940,491,3639,64,113,447,624,4263,-6.430476043,106.8377813
CIMANGGIS,40,3708,1663,983,6354,113,153,636,902,7256,-6.36851649,106.8699281
TAPOS,41,4965,2217,1236,8418,279,379,1217,1875,10293,-6.419127313,106.8807629
BEJI,50,2434,1064,626,4124,154,126,466,746,4870,-6.373272589,106.8188222
LIMO,60,1904,856,463,3223,79,119,388,586,3809,-6.368582675,106.7807757
CINERE,61,1065,505,317,1887,30,49,198,277,2164,-6.331583757,106.7893785
CIMAHI SELATAN,10,6095,2239,1011,9345,251,505,1471,2227,11572,-6.908100902,107.5399534
CIMAHI TENGAH,20,4763,1791,839,7393,136,257,962,1355,8748,-6.884447197,107.539789
CIMAHI UTARA,30,4562,1745,870,7177,128,372,1099,1599,8776,-6.862571249,107.5508105
KAWALU,10,4639,1542,538,6719,321,768,1521,2610,9329,-7.40206126,108.2020408
TAMANSARI,20,4934,1654,694,7282,266,670,1511,2447,9729,-7.396959811,108.2487212
CIBEUREUM,30,2883,1161,506,4550,79,280,774,1133,5683,-7.354898231,108.2594007
PURBARATU,31,2377,942,465,3784,72,234,514,820,4604,-7.332973515,108.2655818
TAWANG,40,1280,544,273,2097,37,100,276,413,2510,-7.339014127,108.2277825
CIHIDEUNG,50,2279,900,420,3599,55,274,562,891,4490,-7.33589033,108.2129023
MANGKUBUMI,60,4420,1610,664,6694,232,520,1163,1915,8609,-7.346141019,108.1848236
INDIHIANG,70,2251,916,377,3544,79,211,558,848,4392,-7.290795893,108.198192
BUNGURSARI,71,2232,829,294,3355,74,296,590,960,4315,-7.308252891,108.1783644
CIPEDES,80,2754,1016,483,4253,74,301,683,1058,5311,-7.314013394,108.2230564
BANJAR,10,2005,713,328,3046,45,155,515,715,3761,-7.374182438,108.5037242
PURWAHARJA,20,397,163,55,615,7,39,118,164,779,-7.351292806,108.556295
PATARUMAN,30,2007,688,268,2963,81,208,554,843,3806,-7.3911343,108.5644122
LANGENSARI,40,1991,793,303,3087,42,172,481,695,3782,-7.367281075,108.6291851
DAYEUHLUHUR,10,1775,585,159,2519,60,195,510,765,3284,-7.228624601,108.6134981
WANAREJA,20,4102,1274,340,5716,199,645,1211,2055,7771,-7.305993636,108.681355
MAJENANG,30,6374,2079,576,9029,311,1071,2134,3516,12545,-7.263871895,108.7551474
CIMANGGU,40,4842,1671,466,6979,212,750,1635,2597,9576,-7.310476338,108.8417553
KARANGPUCUNG,50,3910,1464,429,5803,161,485,1184,1830,7633,-7.381188044,108.902522
CIPARI,60,3550,1357,423,5330,100,381,988,1469,6799,-7.404942057,108.7761522
SIDAREJA,70,3399,1267,342,5008,74,443,1167,1684,6692,-7.462646855,108.7981545
KEDUNGREJA,80,3998,1481,476,5955,131,367,986,1484,7439,-7.519926414,108.7714077
PATIMUAN,90,2342,830,207,3379,95,335,717,1147,4526,-7.612572936,108.7839708
GANDRUNGMANGU,100,5826,2287,811,8924,195,712,1627,2534,11458,-7.507096388,108.8522475
BANTARSARI,110,3325,1196,329,4850,112,503,998,1613,6463,-7.53794171,108.910246
KAWUNGANTEN,120,4761,1810,615,7186,173,569,1002,1744,8930,-7.602298858,108.9396345
KAMPUNG LAUT,121,1109,365,93,1567,48,160,318,526,2093,-7.669198972,108.8759907
JERUKLEGI,130,3502,1163,340,5005,120,454,1000,1574,6579,-7.593562128,109.0162968
KESUGIHAN,140,4786,1676,449,6911,134,560,1483,2177,9088,-7.626201957,109.0914714
ADIPALA,150,3191,1303,417,4911,93,327,934,1354,6265,-7.664057224,109.1665045
MAOS,160,1499,528,170,2197,38,168,320,526,2723,-7.604579483,109.1577824
SAMPANG,170,1853,680,268,2801,46,137,420,603,3404,-7.580762697,109.2013568
KROYA,180,5425,2126,797,8348,143,466,1428,2037,10385,-7.626354204,109.2371568
BINANGUN,190,3039,1153,338,4530,108,306,959,1373,5903,-7.674594917,109.271364
NUSAWUNGU,200,4309,1493,434,6236,154,457,1078,1689,7925,-7.672930141,109.344903
CILACAP SELATAN,710,2426,807,382,3615,58,155,559,772,4387,-7.733288658,108.9167775
CILACAP TENGAH,720,1776,723,263,2762,51,140,488,679,3441,-7.691003241,108.9905605
CILACAP UTARA,730,1746,640,252,2638,45,174,494,713,3351,-7.671560652,109.0348316
LUMBIR,10,2298,705,187,3190,87,318,491,896,4086,-7.465614807,108.9753982
WANGON,20,2754,1060,368,4182,110,313,829,1252,5434,-7.512976659,109.0540976
JATILAWANG,30,2381,897,305,3583,82,263,583,928,4511,-7.545220609,109.1122444
RAWALO,40,1724,660,239,2623,35,151,442,628,3251,-7.523231525,109.164361
KEBASEN,50,2628,919,268,3815,75,278,573,926,4741,-7.546247707,109.2271234
KEMRANJEN,60,2674,966,372,4012,71,198,622,891,4903,-7.590802547,109.3083255
SUMPIUH,70,2196,823,293,3312,82,246,523,851,4163,-7.59573701,109.3673506
TAMBAK,80,1855,702,253,2810,78,205,466,749,3559,-7.60092611,109.4094705
SOMAGEDE,90,1472,551,203,2226,73,140,319,532,2758,-7.525659557,109.3445639
KALIBAGOR,100,1737,685,272,2694,63,168,505,736,3430,-7.487696266,109.304358
BANYUMAS,110,1729,607,202,2538,73,170,383,626,3164,-7.53225284,109.2733848
PATIKRAJA,120,1740,709,207,2656,60,198,586,844,3500,-7.476948379,109.212625
PURWOJATI,130,1315,476,126,1917,54,144,257,455,2372,-7.48451303,109.1085836
AJIBARANG,140,3786,1332,373,5491,141,603,1237,1981,7472,-7.425407219,109.0728746
GUMELAR,150,1945,703,178,2826,99,288,458,845,3671,-7.38869649,108.9965268
PEKUNCEN,160,3224,1125,383,4732,110,440,995,1545,6277,-7.348279791,109.0838977
CILONGOK,170,5922,1799,504,8225,333,916,2150,3399,11624,-7.372588486,109.1494228
KARANGLEWAS,180,2411,835,275,3521,91,284,701,1076,4597,-7.399114015,109.1866405
KEDUNG BANTENG,190,2525,894,303,3722,103,361,764,1228,4950,-7.336645669,109.1997455
BATURRADEN,200,1799,643,217,2659,65,253,591,909,3568,-7.314987331,109.2250604
SUMBANG,210,4682,1226,366,6274,274,825,1781,2880,9154,-7.340815335,109.2614127
KEMBARAN,220,2428,846,278,3552,112,385,887,1384,4936,-7.413109973,109.2882503
SOKARAJA,230,1952,811,311,3074,64,198,596,858,3932,-7.451132003,109.2913336
PURWOKERTO SELATAN,710,941,336,159,1436,28,88,307,423,1859,-7.446649884,109.2441506
PURWOKERTO BARAT,720,655,283,120,1058,26,39,172,237,1295,-7.421857269,109.215699
PURWOKERTO TIMUR,730,703,280,115,1098,16,63,202,281,1379,-7.419978461,109.2464047
PURWOKERTO UTARA,740,751,300,117,1168,18,54,190,262,1430,-7.402424476,109.2406923
KEMANGKON,10,3152,1274,302,4728,92,380,1019,1491,6219,-7.455364178,109.3705527
BUKATEJA,20,3865,1437,388,5690,115,465,1181,1761,7451,-7.434650034,109.4502028
KEJOBONG,30,2683,969,238,3890,122,380,914,1416,5306,-7.400569354,109.4888212
PENGADEGAN,40,2232,611,130,2973,63,336,736,1135,4108,-7.366392597,109.4851061
KALIGONDANG,50,3313,1260,338,4911,54,319,841,1214,6125,-7.375533526,109.4164028
PURBALINGGA,60,1512,578,178,2268,31,133,393,557,2825,-7.398324366,109.3743166
KALIMANAH,70,1560,621,169,2350,58,168,536,762,3112,-7.41426546,109.3429566
PADAMARA,80,1837,724,153,2714,60,243,596,899,3613,-7.379322667,109.3218109
KUTASARI,90,3978,1096,273,5347,231,661,1399,2291,7638,-7.320972228,109.2928004
BOJONGSARI,100,2985,938,235,4158,101,444,1038,1583,5741,-7.310051872,109.3122929
MREBET,110,3884,1322,369,5575,255,693,1411,2359,7934,-7.308188325,109.3439372
BOBOTSARI,120,2479,909,224,3612,107,350,963,1420,5032,-7.281568135,109.3673049
KARANGREJA,130,3416,940,169,4525,143,663,1201,2007,6532,-7.238394927,109.3099542
KARANGJAMBU,131,1716,436,115,2267,113,347,498,958,3225,-7.218400805,109.404648
KARANGANYAR,140,2502,789,202,3493,105,392,740,1237,4730,-7.300149911,109.4062356
KERTANEGARA,141,2414,860,239,3513,93,284,624,1001,4514,-7.287759813,109.4314586
KARANGMONCOL,150,3238,1379,406,5023,74,253,894,1221,6244,-7.266217086,109.4622813
REMBANG,160,3249,1052,232,4533,155,605,1084,1844,6377,-7.289150668,109.5232611
SUSUKAN,10,2663,831,215,3709,121,400,976,1497,5206,-7.504531692,109.4070279
PURWOREJO KLAMPOK,20,1350,507,120,1977,41,202,533,776,2753,-7.478002881,109.4498016
MANDIRAJA,30,2053,602,131,2786,138,355,669,1162,3948,-7.480836599,109.4980051
PURWANEGARA,40,2877,780,131,3788,281,676,1285,2242,6030,-7.467801174,109.5698316
BAWANG,50,1622,424,117,2163,115,303,575,993,3156,-7.429162439,109.6275962
BANJARNEGARA,60,1199,427,187,1813,88,171,404,663,2476,-7.412463634,109.7146418
PAGEDONGAN,61,1538,370,77,1985,140,383,572,1095,3080,-7.458072115,109.6865127
SIGALUH,70,1023,348,117,1488,51,148,335,534,2022,-7.422329471,109.7820522
MADUKARA,80,1185,371,101,1657,89,201,431,721,2378,-7.363607949,109.7305576
BANJARMANGU,90,1694,385,93,2172,103,346,712,1161,3333,-7.329978404,109.6827757
WANADADI,100,1243,450,160,1853,43,134,432,609,2462,-7.368446158,109.6378707
RAKIT,110,1403,537,156,2096,62,196,493,751,2847,-7.416250806,109.5468628
PUNGGELAN,120,4169,1101,184,5454,341,877,1804,3022,8476,-7.335733521,109.5921362
KARANGKOBAR,130,1329,352,79,1760,93,291,654,1038,2798,-7.278456006,109.7119261
PAGENTAN,140,1156,266,20,1442,96,357,577,1030,2472,-7.309140085,109.7916963
PEJAWARAN,150,2372,601,108,3081,220,556,1005,1781,4862,-7.24442875,109.8088614
BATUR,160,1459,305,50,1814,102,371,607,1080,2894,-7.206017217,109.8532227
WANAYASA,170,3102,841,146,4089,276,688,1229,2193,6282,-7.237946886,109.753788
KALIBENING,180,2024,421,83,2528,184,584,942,1710,4238,-7.226216291,109.6608235
PANDANARUM,181,931,211,20,1162,82,251,390,723,1885,-7.25100292,109.5913658
AYAH,10,2613,1017,278,3908,115,202,632,949,4857,-7.712126873,109.4187172
BUAYAN,20,3130,1124,391,4645,300,441,951,1692,6337,-7.679352442,109.4697283
PURING,30,2552,1154,367,4073,76,169,564,809,4882,-7.733314939,109.5251995
PETANAHAN,40,2699,1034,472,4205,65,142,500,707,4912,-7.736044699,109.5930333
KLIRONG,50,3234,1400,687,5321,98,213,716,1027,6348,-7.735924152,109.6348399
BULUSPESANTREN,60,2827,1184,536,4547,66,165,666,897,5444,-7.753874833,109.6784995
AMBAL,70,3039,1439,594,5072,62,181,657,900,5972,-7.767697246,109.7370569
MIRIT,80,2657,1233,522,4412,49,202,578,829,5241,-7.785224441,109.7929197
BONOROWO,81,1033,543,258,1834,35,64,259,358,2192,-7.757859913,109.8160341
PREMBUN,90,1447,703,317,2467,41,102,314,457,2924,-7.70286605,109.7974389
PADURESO,91,978,470,137,1585,14,110,350,474,2059,-7.632488725,109.7873318
KUTOWINANGUN,100,2715,1148,549,4412,37,154,484,675,5087,-7.701961359,109.7479398
ALIAN,110,4756,1946,881,7583,171,445,961,1577,9160,-7.630757077,109.7084267
PONCOWARNO,111,1129,497,170,1796,29,111,371,511,2307,-7.658835007,109.7487315
KEBUMEN,120,6341,2766,1499,10606,130,317,1177,1624,12230,-7.682352907,109.6812165
PEJAGOAN,130,3122,1333,604,5059,100,265,917,1282,6341,-7.626786322,109.6421273
SRUWENG,140,3261,1204,594,5059,147,316,812,1275,6334,-7.643194673,109.6113454
ADIMULYO,150,1695,723,328,2746,29,61,266,356,3102,-7.674714608,109.5581639
KUWARASAN,160,2712,1040,445,4197,67,196,681,944,5141,-7.659314652,109.511836
ROWOKELE,170,2928,1140,511,4579,120,312,856,1288,5867,-7.600029021,109.4452213
SEMPOR,180,4175,1657,648,6480,195,490,1111,1796,8276,-7.549621957,109.5121686
GOMBONG,190,1944,790,508,3242,49,64,300,413,3655,-7.609151596,109.5205697
KARANGANYAR,200,1769,669,332,2770,40,138,360,538,3308,-7.611528788,109.5672883
KARANGGAYAM,210,3760,1382,530,5672,285,686,1205,2176,7848,-7.547260029,109.6175398
SADANG,220,1405,449,119,1973,98,300,467,865,2838,-7.507439674,109.7253364
KARANGSAMBUNG,221,2928,983,260,4171,116,485,711,1312,5483,-7.572049148,109.7026493
GRABAG,10,1510,605,367,2482,29,70,285,384,2866,-7.810926978,109.8796735
NGOMBOL,20,935,386,171,1492,25,27,127,179,1671,-7.827282594,109.9480511
PURWODADI,30,989,372,200,1561,39,48,153,240,1801,-7.834719415,109.9990869
BAGELEN,40,1005,427,212,1644,30,34,153,217,1861,-7.811277658,110.0400579
KALIGESING,50,1227,459,202,1888,50,100,266,416,2304,-7.731557281,110.094828
PURWOREJO,60,1724,795,432,2951,46,84,344,474,3425,-7.722316631,110.0304203
BANYU URIP,70,1057,432,202,1691,8,40,169,217,1908,-7.755403002,109.9765745
BAYAN,80,1956,742,363,3061,35,79,346,460,3521,-7.72315865,109.9431982
KUTOARJO,90,1986,780,319,3085,36,79,316,431,3516,-7.722985095,109.9074893
BUTUH,100,1420,593,278,2291,43,65,205,313,2604,-7.744384395,109.8584918
PITURUH,110,1706,720,402,2828,43,143,275,461,3289,-7.641396624,109.8365187
KEMIRI,120,2085,775,284,3144,70,172,536,778,3922,-7.647859148,109.9043833
BRUNO,130,3159,988,248,4395,320,579,1000,1899,6294,-7.568295701,109.921956
GEBANG,140,1777,689,314,2780,69,211,396,676,3456,-7.642444547,109.992695
LOANO,150,1563,572,192,2327,49,135,405,589,2916,-7.667866005,110.065388
BENER,160,2441,891,257,3589,75,315,713,1103,4692,-7.605171781,110.0666711
WADASLINTANG,10,2487,865,170,3522,119,261,594,974,4496,-7.548307228,109.8002402
KEPIL,20,3812,1047,200,5059,226,773,1317,2316,7375,-7.511971166,110.0147696
SAPURAN,30,3355,926,222,4503,249,646,977,1872,6375,-7.450757318,109.9946724
KALIBAWANG,31,1264,460,100,1824,52,168,340,560,2384,-7.501046252,109.9239292
KALIWIRO,40,1770,606,136,2512,79,263,452,794,3306,-7.47333104,109.8348626
LEKSONO,50,1358,442,102,1902,42,174,362,578,2480,-7.401692739,109.856172
SUKOHARJO,51,1256,350,52,1658,73,256,440,769,2427,-7.376854456,109.8074889
SELOMERTO,60,1717,555,133,2405,56,204,404,664,3069,-7.41625682,109.9031575
KALIKAJAR,70,3549,868,206,4623,259,885,1186,2330,6953,-7.401859879,109.9940228
KERTEK,80,4256,1223,325,5804,272,791,1355,2418,8222,-7.356113157,109.9773318
WONOSOBO,90,2651,988,329,3968,89,311,647,1047,5015,-7.359795202,109.9181536
WATUMALANG,100,2143,453,78,2674,196,432,587,1215,3889,-7.313527103,109.8499358
MOJOTENGAH,110,3045,885,221,4151,276,711,1056,2043,6194,-7.316933128,109.9104233
GARUNG,120,3098,877,171,4146,148,599,1046,1793,5939,-7.287414789,109.9337803
KEJAJAR,130,2415,653,159,3227,136,448,804,1388,4615,-7.244206842,109.9308761
SALAMAN,10,3166,1290,518,4974,127,351,969,1447,6421,-7.580707642,110.1237861
BOROBUDUR,20,2058,883,343,3284,91,228,568,887,4171,-7.61950147,110.1957922
NGLUWAR,30,1052,478,219,1749,38,60,202,300,2049,-7.659964208,110.2754804
SALAM,40,1186,526,244,1956,41,79,247,367,2323,-7.621432258,110.3002576
SRUMBUNG,50,1561,712,241,2514,52,109,373,534,3048,-7.587079367,110.3592287
DUKUN,60,1362,643,262,2267,51,138,415,604,2871,-7.544631905,110.3681005
MUNTILAN,70,2265,933,470,3668,71,138,458,667,4335,-7.59232642,110.2709626
MUNGKID,80,2227,1065,481,3773,72,178,533,783,4556,-7.567819894,110.2467495
SAWANGAN,90,2240,736,265,3241,121,420,765,1306,4547,-7.503878338,110.356076
CANDIMULYO,100,2704,963,326,3993,127,403,898,1428,5421,-7.498425991,110.2802588
MERTOYUDAN,110,2400,1107,438,3945,69,166,551,786,4731,-7.539700835,110.2089662
TEMPURAN,120,2239,1006,380,3625,74,229,663,966,4591,-7.536123068,110.1596526
KAJORAN,130,2873,975,302,4150,246,546,1084,1876,6026,-7.495623288,110.0823785
KALIANGKRIK,140,3694,965,258,4917,258,907,1347,2512,7429,-7.447065703,110.1149272
BANDONGAN,150,3331,1282,494,5107,131,439,1139,1709,6816,-7.46193047,110.1808657
WINDUSARI,160,2752,901,227,3880,140,469,996,1605,5485,-7.406896793,110.1591523
SECANG,170,2850,1269,506,4625,142,229,722,1093,5718,-7.409503396,110.2504657
TEGALREJO,180,1398,549,198,2145,88,186,392,666,2811,-7.456441911,110.2687057
PAKIS,190,2351,782,189,3322,421,778,1253,2452,5774,-7.452161442,110.3614669
GRABAG,200,4896,1844,572,7312,267,727,1652,2646,9958,-7.378633435,110.3262252
NGABLAK,210,1440,444,95,1979,95,381,652,1128,3107,-7.395119403,110.3814689
SELO,10,1267,369,92,1728,155,377,580,1112,2840,-7.499106347,110.4502372
AMPEL,20,2678,1133,350,4161,106,382,820,1308,5469,-7.451394881,110.51785
CEPOGO,30,1726,682,203,2611,85,237,519,841,3452,-7.512267015,110.5227049
MUSUK,40,1660,718,263,2641,88,202,513,803,3444,-7.568214912,110.5280822
BOYOLALI,50,954,444,191,1589,19,58,200,277,1866,-7.513387645,110.5941442
MOJOSONGO,60,931,423,220,1574,20,51,174,245,1819,-7.545075361,110.6141855
TERAS,70,808,409,184,1401,23,34,195,252,1653,-7.543850964,110.6538766
SAWIT,80,597,359,186,1142,13,31,162,206,1348,-7.573975147,110.6893153
BANYUDONO,90,1066,582,296,1944,14,48,250,312,2256,-7.53703364,110.6940254
SAMBI,100,1169,557,238,1964,30,67,291,388,2352,-7.478725005,110.684923
NGEMPLAK,110,2026,924,384,3334,76,175,549,800,4134,-7.509132819,110.7683601
NOGOSARI,120,1479,694,324,2497,44,87,432,563,3060,-7.460424713,110.7570935
SIMO,130,1474,722,368,2564,30,61,361,452,3016,-7.431018067,110.6837397
KARANGGEDE,140,1628,712,269,2609,45,153,367,565,3174,-7.370628508,110.6573686
KLEGO,150,1704,740,232,2676,45,213,538,796,3472,-7.369476886,110.7094514
ANDONG,160,2218,1063,428,3709,57,185,604,846,4555,-7.367422647,110.7635799
KEMUSU,170,2004,742,202,2948,68,212,532,812,3760,,
WONOSEGORO,180,3207,1290,373,4870,143,453,1133,1729,6599,-7.282192287,110.6550035
JUWANGI,190,997,360,112,1469,61,169,313,543,2012,-7.211405478,110.7449682
PRAMBANAN,10,2043,919,425,3387,24,48,429,501,3888,-7.747313897,110.5115268
GANTIWARNO,20,1726,870,467,3063,104,60,362,526,3589,-7.777289735,110.5594652
WEDI,30,2343,1108,637,4088,148,104,528,780,4868,-7.771737995,110.6001741
BAYAT,40,3482,1626,867,5975,128,203,818,1149,7124,-7.772040626,110.6548734
CAWAS,50,2305,1116,688,4109,160,80,489,729,4838,-7.761671979,110.7127965
TRUCUK,60,3844,1721,1032,6597,94,164,806,1064,7661,-7.725190764,110.6700539
KALIKOTES,70,1237,483,240,1960,38,55,282,375,2335,-7.726081915,110.6241078
KEBONARUM,80,657,275,151,1083,18,17,124,159,1242,-7.697663395,110.5616138
JOGONALAN,90,2317,1032,514,3863,118,115,446,679,4542,-7.728557466,110.5471495
MANISRENGGO,100,1717,705,305,2727,76,103,432,611,3338,-7.68665523,110.4985997
KARANGNONGKO,110,1227,500,257,1984,62,124,332,518,2502,-7.66586644,110.5418327
NGAWEN,120,1768,874,485,3127,23,51,347,421,3548,-7.671495631,110.6058576
CEPER,130,2833,1226,702,4761,85,98,568,751,5512,-7.680361165,110.6703484
PEDAN,140,1968,891,454,3313,65,83,461,609,3922,-7.693285874,110.7083658
KARANGDOWO,150,1911,881,530,3322,66,102,484,652,3974,-7.706451095,110.7450237
JUWIRING,160,2629,1182,566,4377,92,132,598,822,5199,-7.658643012,110.7381588
WONOSARI,170,2761,1164,593,4518,72,166,729,967,5485,-7.626560188,110.7434252
DELANGGU,180,1354,675,377,2406,60,47,269,376,2782,-7.628040521,110.691433
POLANHARJO,190,1328,561,362,2251,63,51,267,381,2632,-7.614246069,110.6637072
KARANGANOM,200,1558,674,347,2579,65,56,299,420,2999,-7.644184096,110.6340657
TULUNG,210,2126,933,481,3540,104,147,534,785,4325,-7.598440268,110.6048461
JATINOM,220,2274,899,345,3518,88,229,642,959,4477,-7.634107288,110.5752221
KEMALANG,230,1613,502,119,2234,115,303,595,1013,3247,-7.610993663,110.4888499
KLATEN SELATAN,710,990,413,201,1604,19,41,194,254,1858,-7.719880363,110.5879334
KLATEN TENGAH,720,974,459,202,1635,19,31,235,285,1920,-7.715665667,110.6083228
KLATEN UTARA,730,1046,461,228,1735,35,56,230,321,2056,-7.690071502,110.6161671
WERU,10,1736,869,517,3122,78,128,505,711,3833,-7.78524506,110.7583793
BULU,20,977,451,248,1676,30,72,226,328,2004,-7.767914657,110.8290856
TAWANGSARI,30,1871,956,529,3356,94,113,456,663,4019,-7.727933036,110.78534
SUKOHARJO,40,2666,1181,606,4453,86,141,593,820,5273,-7.679777877,110.8187483
NGUTER,50,1740,810,451,3001,89,140,443,672,3673,-7.734177862,110.8877737
BENDOSARI,60,1415,670,372,2457,57,123,352,532,2989,-7.686836647,110.8917621
POLOKARTO,70,3031,1305,712,5048,104,189,700,993,6041,-7.643997561,110.9014118
MOJOLABAN,80,2987,1245,739,4971,106,133,603,842,5813,-7.595849417,110.8712375
GROGOL,90,3331,1563,1031,5925,95,157,732,984,6909,-7.61319341,110.8135548
BAKI,100,1844,843,452,3139,70,133,481,684,3823,-7.607918992,110.7786514
GATAK,110,1646,679,406,2731,68,70,345,483,3214,-7.590153027,110.7411847
KARTASURA,120,2380,1125,656,4161,143,78,492,713,4874,-7.557964198,110.7475055
PRACIMANTORO,10,1966,808,294,3068,100,264,731,1095,4163,-8.071704308,110.8160907
PARANGGUPITO,20,579,234,68,881,53,88,184,325,1206,-8.170059362,110.8642492
GIRITONTRO,30,832,350,146,1328,30,76,155,261,1589,-8.09392791,110.8925208
GIRIWOYO,40,1332,589,357,2278,56,99,270,425,2703,-8.038518322,110.9466482
BATUWARNO,50,439,213,102,754,13,27,126,166,920,-7.983944766,111.008074
KARANGTENGAH,60,355,142,23,520,21,87,152,260,780,-8.029706257,111.0699294
TIRTOMOYO,70,1501,686,333,2520,116,193,496,805,3325,-7.953873579,111.0842721
NGUNTORONADI,80,848,404,200,1452,28,46,205,279,1731,-7.897660083,110.9671977
BATURETNO,90,1352,649,367,2368,27,55,224,306,2674,-7.964330363,110.9378621
EROMOKO,100,1070,399,212,1681,50,84,254,388,2069,-7.967247006,110.8213504
WURYANTORO,110,688,331,193,1212,29,44,149,222,1434,,
MANYARAN,120,1291,629,334,2254,60,112,379,551,2805,-7.845545834,110.8154568
SELOGIRI,130,912,446,320,1678,46,57,181,284,1962,-7.792709465,110.8833095
WONOGIRI,140,1197,534,336,2067,62,75,257,394,2461,-7.802210121,110.9395889
NGADIROJO,150,1124,462,207,1793,59,118,339,516,2309,-7.827043365,111.0053873
SIDOHARJO,160,866,409,211,1486,149,137,312,598,2084,-7.861350271,111.055735
JATIROTO,170,885,302,97,1284,49,129,322,500,1784,-7.895543905,111.1228491
KISMANTORO,180,1744,621,144,2509,179,383,847,1409,3918,-7.903507037,111.2436833
PURWANTORO,190,1612,673,160,2445,93,238,667,998,3443,-7.835127688,111.2618363
BULUKERTO,200,775,275,105,1155,37,76,219,332,1487,-7.765107442,111.2164512
PUHPELEM,201,606,251,88,945,40,70,261,371,1316,-7.76841939,111.2656706
SLOGOHIMO,210,1397,610,187,2194,89,172,506,767,2961,-7.818300382,111.1903567
JATISRONO,220,935,403,134,1472,44,131,294,469,1941,-7.844744658,111.1329675
JATIPURNO,230,834,294,143,1271,54,105,188,347,1618,-7.778185705,111.1417975
GIRIMARTO,240,749,302,158,1209,95,113,384,592,1801,-7.775661468,111.0859352
JATIPURO,10,1052,432,199,1683,34,76,246,356,2039,-7.744947802,111.0150614
JATIYOSO,20,1284,543,141,1968,69,200,510,779,2747,-7.712123756,111.1055517
JUMAPOLO,30,1294,545,166,2005,54,125,446,625,2630,-7.705840633,111.0029676
JUMANTONO,40,1883,682,219,2784,106,144,519,769,3553,-7.659724928,110.9925735
MATESIH,50,1770,697,230,2697,53,113,382,548,3245,-7.643063715,111.0443028
TAWANGMANGU,60,1348,504,125,1977,25,118,384,527,2504,-7.663945656,111.1387852
NGARGOYOSO,70,1624,594,174,2392,62,162,482,706,3098,-7.609139592,111.1233014
KARANGPANDAN,80,1700,661,238,2599,47,110,406,563,3162,-7.616428748,111.0623566
KARANGANYAR,90,1821,729,284,2834,50,112,393,555,3389,-7.603282004,110.9777692
TASIKMADU,100,1751,735,395,2881,51,52,264,367,3248,-7.569337517,110.9380987
JATEN,110,1269,497,233,1999,23,55,250,328,2327,-7.564011604,110.8949114
COLOMADU,120,1364,623,311,2298,27,41,211,279,2577,-7.535590813,110.760228
GONDANGREJO,130,2297,1016,452,3765,62,134,589,785,4550,-7.499476283,110.8453929
KEBAKKRAMAT,140,1759,816,380,2955,27,55,301,383,3338,-7.520290781,110.9236619
MOJOGEDANG,150,2846,1065,344,4255,134,280,821,1235,5490,-7.554200123,111.0019561
KERJO,160,1261,463,147,1871,72,97,348,517,2388,-7.543320285,111.0666263
JENAWI,170,1446,530,117,2093,87,137,344,568,2661,-7.563134516,111.1367773
KALIJAMBE,10,1919,830,486,3235,83,129,548,760,3995,-7.4359714,110.8135767
PLUPUH,20,1557,704,330,2591,33,132,451,616,3207,-7.439565441,110.8886878
MASARAN,30,2434,1087,499,4020,100,138,553,791,4811,-7.477887295,110.9372221
KEDAWUNG,40,1386,554,184,2124,55,83,368,506,2630,-7.49714546,111.0267551
SAMBIREJO,50,1214,523,167,1904,46,114,390,550,2454,-7.497316069,111.1084224
GONDANG,60,1222,533,282,2037,54,79,286,419,2456,-7.432465295,111.099916
SAMBUNG MACAN,70,1589,761,412,2762,123,78,338,539,3301,-7.370264965,111.1013601
NGRAMPAL,80,1299,620,312,2231,36,55,275,366,2597,-7.387358806,111.0497845
KARANGMALANG,90,1587,621,282,2490,70,105,319,494,2984,-7.455689267,111.0203757
SRAGEN,100,988,490,272,1750,84,61,221,366,2116,-7.404680169,111.0186692
SIDOHARJO,110,1254,573,310,2137,34,66,270,370,2507,-7.422172531,110.9675899
TANON,120,2218,926,402,3546,88,211,768,1067,4613,-7.382617213,110.9176689
GEMOLONG,130,2025,851,426,3302,85,106,382,573,3875,-7.395803656,110.8410189
MIRI,140,1875,737,276,2888,66,172,517,755,3643,,
SUMBERLAWANG,150,2504,970,362,3836,101,281,742,1124,4960,-7.314048856,110.8678426
MONDOKAN,160,1378,460,194,2032,120,225,452,797,2829,-7.319103685,110.9296941
SUKODONO,170,1169,515,222,1906,54,129,359,542,2448,-7.32511718,110.975284
GESI,180,684,262,93,1039,53,95,229,377,1416,-7.328579046,111.0069059
TANGEN,190,1311,491,148,1950,62,230,507,799,2749,-7.291027295,111.056934
JENAR,200,1785,588,218,2591,82,178,450,710,3301,-7.308638545,111.1102509
KEDUNGJATI,10,2329,864,267,3460,71,231,922,1224,4684,-7.171289343,110.6329533
KARANGRAYUNG,20,3334,1057,272,4663,176,661,1291,2128,6791,-7.148922509,110.7649504
PENAWANGAN,30,2032,599,156,2787,168,345,783,1296,4083,-7.102919952,110.8312633
TOROH,40,3363,1110,251,4724,152,565,1215,1932,6656,-7.160001898,110.9191894
GEYER,50,3570,1334,414,5318,194,549,1375,2118,7436,-7.230280772,110.936541
PULOKULON,60,5407,1865,376,7648,116,776,1860,2752,10400,-7.167177396,111.0544108
KRADENAN,70,3228,918,194,4340,141,704,1381,2226,6566,-7.176606597,111.1244245
GABUS,80,2687,874,153,3714,130,480,1001,1611,5325,-7.186808699,111.1935127
NGARINGAN,90,3142,881,197,4220,263,792,1236,2291,6511,-7.046449159,111.1669969
WIROSARI,100,3485,1100,282,4867,182,776,1369,2327,7194,-7.037061537,111.0848926
TAWANGHARJO,110,2275,778,255,3308,176,375,783,1334,4642,-7.043962205,111.0090516
GROBOGAN,120,3668,1053,290,5011,210,698,1487,2395,7406,-7.01434085,110.9568457
PURWODADI,130,3338,1151,308,4797,145,417,1178,1740,6537,-7.098548665,110.9154831
BRATI,140,1787,530,118,2435,97,349,760,1206,3641,-7.022902265,110.8907221
KLAMBU,150,1245,475,132,1852,43,160,451,654,2506,-7.001514829,110.8124445
GODONG,160,2250,910,300,3460,94,287,808,1189,4649,-7.052086733,110.7544802
GUBUG,170,2578,1120,418,4116,70,263,878,1211,5327,-7.066745249,110.6771658
TEGOWANU,180,1743,740,229,2712,88,201,635,924,3636,-7.037922179,110.6266032
TANGGUNGHARJO,190,1694,704,267,2665,63,145,509,717,3382,-7.103314197,110.6165016
JATI,10,1344,451,118,1913,107,276,487,870,2783,-7.222464744,111.2965575
RANDUBLATUNG,20,3513,1339,478,5330,177,409,1011,1597,6927,-7.18678706,111.3927575
KRADENAN,30,2579,859,288,3726,124,305,650,1079,4805,-7.284036648,111.4316353
KEDUNGTUBAN,40,2748,1199,544,4491,99,274,768,1141,5632,-7.167535684,111.5013131
CEPU,50,1663,676,256,2595,135,187,470,792,3387,-7.163180403,111.5666881
SAMBONG,60,1068,429,169,1666,60,86,277,423,2089,-7.089137696,111.5568609
JIKEN,70,1005,309,114,1428,96,165,330,591,2019,-7.011213724,111.5471253
BOGOREJO,80,1048,349,76,1473,144,217,406,767,2240,-6.928884107,111.5227541
JEPON,90,1398,481,204,2083,73,155,391,619,2702,-7.016265986,111.4589052
KOTA BLORA,100,1673,658,231,2562,155,186,515,856,3418,-6.956802506,111.434239
BANJAREJO,110,3482,1070,311,4863,262,574,1202,2038,6901,-7.049159964,111.3729836
TUNJUNGAN,120,1730,603,152,2485,70,215,583,868,3353,-6.93337127,111.3791101
JAPAH,130,1221,387,93,1701,59,204,477,740,2441,-6.9195112,111.2926803
NGAWEN,140,2311,779,252,3342,127,338,755,1220,4562,-7.027758114,111.3000293
KUNDURAN,150,1860,568,186,2614,128,324,608,1060,3674,-7.066797666,111.2519578
TODANAN,160,2905,1028,267,4200,152,436,1087,1675,5875,-6.936410793,111.187326
SUMBER,10,1766,768,415,2949,91,134,598,823,3772,-6.799068017,111.2842643
BULU,20,1493,531,219,2243,71,171,466,708,2951,-6.855276973,111.3767442
GUNEM,30,1128,418,185,1731,36,113,390,539,2270,-6.84373751,111.4781242
SALE,40,1452,567,197,2216,37,169,548,754,2970,-6.853770242,111.5635056
SARANG,50,3736,1372,544,5652,84,342,1308,1734,7386,-6.771234283,111.6330528
SEDAN,60,3627,1491,678,5796,173,353,1288,1814,7610,-6.757955586,111.5560617
PAMOTAN,70,3400,1327,494,5221,105,348,1303,1756,6977,-6.770349536,111.4598486
SULANG,80,1907,790,335,3032,55,224,727,1006,4038,-6.788415866,111.365064
KALIORI,90,1673,663,316,2652,161,200,562,923,3575,-6.722347936,111.2776585
REMBANG,100,2703,1140,611,4454,82,174,690,946,5400,-6.720459151,111.3723462
PANCUR,110,1773,744,212,2729,31,165,729,925,3654,-6.724235669,111.4806534
KRAGAN,120,3012,1213,477,4702,151,384,1068,1603,6305,-6.691716771,111.5759635
SLUKE,130,1614,636,218,2468,44,171,473,688,3156,-6.650194703,111.5131471
LASEM,140,2266,1080,587,3933,38,140,697,875,4808,-6.687235397,111.4638139
SUKOLILO,10,4442,1599,566,6607,411,714,1704,2829,9436,-6.93562979,110.8934098
KAYEN,20,4013,1882,820,6715,221,347,1430,1998,8713,-6.903459362,110.9884275
TAMBAKROMO,30,1682,678,213,2573,92,256,694,1042,3615,-6.902274954,111.0491971
WINONG,40,1531,727,344,2602,85,184,539,808,3410,-6.847785753,111.0988947
PUCAKWANGI,50,1665,757,329,2751,161,213,647,1021,3772,-6.851216207,111.168039
JAKEN,60,1758,735,306,2799,120,193,664,977,3776,-6.795237032,111.222022
BATANGAN,70,1790,660,222,2672,64,188,672,924,3596,-6.71266677,111.2026884
JUWANA,80,3118,1150,373,4641,139,250,789,1178,5819,-6.704550926,111.1437928
JAKENAN,90,1199,536,205,1940,196,151,461,808,2748,-6.763775762,111.1305043
PATI,100,1962,831,406,3199,51,142,454,647,3846,-6.740301543,111.0573865
GABUS,110,1460,667,274,2401,76,171,565,812,3213,-6.816026707,111.0357948
MARGOREJO,120,1039,407,213,1659,109,113,368,590,2249,-6.766983571,110.9917547
GEMBONG,130,1688,753,460,2901,134,153,486,773,3674,-6.676423818,110.9454767
TLOGOWUNGU,140,2171,811,262,3244,61,236,756,1053,4297,-6.662108011,110.995819
WEDARIJAKSA,150,2287,876,321,3484,157,258,734,1149,4633,-6.685234254,111.0884698
TRANGKIL,160,2305,1060,454,3819,171,256,747,1174,4993,-6.649975401,111.0765707
MARGOYOSO,170,3352,1465,727,5544,189,307,886,1382,6926,-6.607782197,111.0591289
GUNUNG WUNGKAL,180,1226,544,176,1946,63,160,436,659,2605,-6.580771415,110.9786217
CLUWAK,190,2289,936,346,3571,103,162,630,895,4466,-6.528818976,110.9475305
TAYU,200,2884,1182,532,4598,114,255,966,1335,5933,-6.541907702,111.0405279
DUKUHSETI,210,2286,930,331,3547,81,255,778,1114,4661,-6.464205292,111.0087758
KALIWUNGU,10,3183,1263,427,4873,85,368,998,1451,6324,-6.789998682,110.7942703
KOTA KUDUS,20,1534,606,343,2483,17,80,332,429,2912,-6.804408343,110.8437545
JATI,30,2387,956,475,3818,63,165,666,894,4712,-6.828750759,110.8388827
UNDAAN,40,2012,813,255,3080,79,295,786,1160,4240,-6.906854403,110.8266857
MEJOBO,50,2040,798,383,3221,61,136,562,759,3980,-6.839920997,110.888851
JEKULO,60,2575,1163,518,4256,92,262,851,1205,5461,-6.800514808,110.9345016
BAE,70,1350,527,210,2087,27,102,357,486,2573,-6.780077214,110.8657565
GEBOG,80,3386,1348,529,5263,57,276,849,1182,6445,-6.706795896,110.8461543
DAWE,90,3557,1429,514,5500,213,530,1270,2013,7513,-6.708580695,110.8917442
KEDUNG,10,5111,2079,853,8043,91,324,1339,1754,9797,-6.681742523,110.6546586
PECANGAAN,20,2623,900,284,3807,160,342,979,1481,5288,-6.695960306,110.7019925
KALINYAMATAN,21,1948,674,225,2847,62,275,661,998,3845,-6.723613221,110.7171137
WELAHAN,30,3226,1203,349,4778,164,473,1285,1922,6700,-6.765108199,110.7073739
MAYONG,40,3649,1246,315,5210,139,556,1347,2042,7252,-6.703098387,110.7736195
NALUMSARI,50,2842,1166,270,4278,137,398,1118,1653,5931,-6.724379182,110.8016055
BATEALIT,60,3495,1258,315,5068,238,457,1249,1944,7012,-6.63779389,110.774061
TAHUNAN,70,3673,1316,472,5461,85,369,1171,1625,7086,-6.623694714,110.6859784
JEPARA,80,2295,781,240,3316,106,264,705,1075,4391,-6.577324009,110.6732428
MLONGGO,90,3870,1497,468,5835,142,416,1211,1769,7604,-6.521662687,110.705106
PAKIS AJI,91,2936,1050,269,4255,110,355,1007,1472,5727,-6.58593631,110.765742
BANGSRI,100,4464,1828,620,6912,170,517,1499,2186,9098,-6.530242005,110.7736823
KEMBANG,101,2341,813,213,3367,76,259,765,1100,4467,-6.501289572,110.8090401
KELING,110,1164,438,98,1700,36,111,351,498,2198,-6.514117119,110.8703065
DONOROJO,111,1397,520,181,2098,54,178,462,694,2792,-6.443167381,110.9147479
KARIMUNJAWA,120,39,17,4,60,0,5,10,15,75,-5.825831403,110.4319332
MRANGGEN,10,5640,2754,1489,9883,224,287,1467,1978,11861,-7.038051875,110.5183093
KARANGAWEN,20,5483,2519,1283,9285,235,289,1372,1896,11181,-7.076031546,110.5608299
GUNTUR,30,5258,2180,844,8282,196,589,1835,2620,10902,-6.980466826,110.6028731
SAYUNG,40,5321,2305,1099,8725,253,459,1997,2709,11434,-6.924418669,110.5214138
KARANG TENGAH,50,2735,1212,519,4466,84,261,994,1339,5805,-6.919876584,110.5755832
BONANG,60,7465,3008,1133,11606,322,1096,3194,4612,16218,-6.847165921,110.5913981
DEMAK,70,3227,1338,512,5077,194,356,1130,1680,6757,-6.872047737,110.6540758
WONOSALAM,80,3342,1431,474,5247,124,351,1141,1616,6863,-6.918756152,110.667658
DEMPET,90,3044,1225,474,4743,121,266,1021,1408,6151,-6.958878695,110.7393983
KEBONAGUNG,91,1532,627,188,2347,59,184,590,833,3180,-7.002925569,110.7095579
GAJAH,100,2218,942,347,3507,113,220,682,1015,4522,-6.900749487,110.7469535
KARANGANYAR,110,2635,1164,475,4274,173,387,992,1552,5826,-6.847046249,110.7738384
MIJEN,120,2623,1216,522,4361,159,318,1052,1529,5890,-6.810300768,110.7034213
WEDUNG,130,5043,2095,782,7920,180,574,1829,2583,10503,-6.766983984,110.6181242
GETASAN,10,1569,533,144,2246,56,198,440,694,2940,-7.388323089,110.4435915
TENGARAN,20,2017,749,313,3079,47,132,498,677,3756,-7.400433878,110.532088
SUSUKAN,30,1572,646,259,2477,35,102,303,440,2917,-7.410074623,110.6005056
KALIWUNGU,31,933,386,164,1483,19,51,194,264,1747,-7.470380171,110.6191007
SURUH,40,2616,1051,376,4043,75,212,723,1010,5053,-7.349762971,110.5909197
PABELAN,50,1514,565,210,2289,53,130,428,611,2900,-7.304759437,110.542565
TUNTANG,60,1847,681,296,2824,30,119,463,612,3436,-7.27852528,110.4770122
BANYUBIRU,70,1363,525,198,2086,47,104,351,502,2588,,
JAMBU,80,993,372,111,1476,25,86,243,354,1830,-7.291266912,110.3509185
SUMOWONO,90,1058,371,85,1514,39,134,314,487,2001,-7.225440693,110.2988213
AMBARAWA,100,988,370,125,1483,32,84,215,331,1814,-7.258356297,110.395459
BANDUNGAN,101,1056,316,91,1463,51,191,352,594,2057,-7.221700647,110.3632814
BAWEN,110,1193,468,188,1849,31,94,345,470,2319,-7.232248551,110.4468231
BRINGIN,120,1619,619,181,2419,33,184,522,739,3158,-7.228980775,110.5511302
BANCAK,121,917,322,108,1347,38,103,247,388,1735,-7.254274941,110.5986363
PRINGAPUS,130,1682,665,224,2571,54,196,655,905,3476,-7.171525326,110.5024298
BERGAS,140,1085,449,172,1706,23,87,263,373,2079,,
UNGARAN BARAT,151,756,304,122,1182,13,48,195,256,1438,-7.134045693,110.3831864
UNGARAN TIMUR,152,1130,446,176,1752,33,116,373,522,2274,-7.121890559,110.4506387
PARAKAN,10,2046,742,288,3076,62,168,525,755,3831,-7.280044079,110.0906688
KLEDUNG,11,833,207,44,1084,44,163,274,481,1565,-7.330020275,110.0456046
BANSARI,12,793,256,64,1113,25,105,231,361,1474,-7.287494639,110.0466326
BULU,20,1942,628,184,2754,118,331,585,1034,3788,-7.316971721,110.1083681
TEMANGGUNG,30,1970,738,251,2959,52,106,388,546,3505,-7.320147051,110.1815801
TLOGOMULYO,31,933,295,64,1292,46,130,287,463,1755,-7.349549462,110.1194648
TEMBARAK,40,1442,387,104,1933,55,256,443,754,2687,-7.358609206,110.1614939
SELOPAMPANG,41,972,307,88,1367,40,139,287,466,1833,-7.378035667,110.1498043
KRANGGAN,50,1032,426,114,1572,37,95,287,419,1991,-7.330425987,110.2340882
PRINGSURAT,60,1173,404,87,1664,64,138,402,604,2268,-7.330391556,110.289312
KALORAN,70,1844,695,169,2708,67,237,692,996,3704,-7.268387224,110.2460184
KANDANGAN,80,1935,651,197,2783,94,212,553,859,3642,-7.230044734,110.2039912
KEDU,90,1890,636,165,2691,61,260,619,940,3631,-7.261266542,110.136496
NGADIREJO,100,2614,940,432,3986,248,386,795,1429,5415,-7.254037014,110.0428118
JUMO,110,1131,414,113,1658,77,182,385,644,2302,-7.216935609,110.0970891
GEMAWANG,111,1351,407,128,1886,205,267,515,987,2873,-7.184340184,110.1538268
CANDIROTO,120,1436,429,154,2019,112,238,478,828,2847,-7.20216756,110.0582308
BEJEN,121,949,437,297,1683,198,80,177,455,2138,-7.125129755,110.1074602
TRETEP,130,925,225,80,1230,31,162,253,446,1676,-7.182131655,109.9981545
WONOBOYO,131,1073,323,52,1448,54,193,338,585,2033,-7.212518417,110.0041178
PLANTUNGAN,10,1812,589,160,2561,74,294,717,1085,3646,-7.09632284,109.9753349
SUKOREJO,20,1916,497,147,2560,128,466,666,1260,3820,-7.13080168,109.9970674
PAGERRUYUNG,30,1545,548,129,2222,81,317,682,1080,3302,-7.032268621,110.0374458
PATEAN,40,1809,547,120,2476,92,362,683,1137,3613,-7.079575823,110.1028098
SINGOROJO,50,2114,740,227,3081,113,339,769,1221,4302,-7.101647762,110.2173076
LIMBANGAN,60,1088,410,158,1656,62,167,410,639,2295,-7.164171314,110.2870862
BOJA,70,2209,804,286,3299,63,264,787,1114,4413,-7.10513241,110.2975998
KALIWUNGU,80,1669,736,279,2684,38,158,668,864,3548,-6.948946316,110.2710104
KALIWUNGU SELATAN,81,1866,713,282,2861,103,240,763,1106,3967,-7.005608912,110.2401851
BRANGSONG,90,1965,829,293,3087,61,197,776,1034,4121,-6.956757836,110.2214373
PEGANDON,100,1062,425,138,1625,43,110,363,516,2141,-7.001397381,110.1593465
NGAMPEL,101,796,296,125,1217,64,114,265,443,1660,-6.988455632,110.1846253
GEMUH,110,1961,786,256,3003,75,246,679,1000,4003,-6.997653112,110.1170792
RINGINARUM,111,1279,493,117,1889,29,172,470,671,2560,-6.99359168,110.1066019
WELERI,120,1809,739,275,2823,59,176,587,822,3645,-6.982455555,110.073413
ROWOSARI,130,1775,583,171,2529,73,287,781,1141,3670,-6.924860702,110.0649696
KANGKUNG,140,1466,521,136,2123,49,200,518,767,2890,-6.912387615,110.1173549
CEPIRING,150,1569,665,227,2461,74,178,515,767,3228,-6.908661085,110.1525639
PATEBON,160,1574,653,192,2419,54,167,598,819,3238,-6.895346308,110.183262
KOTA KENDAL,170,1099,403,149,1651,54,167,448,669,2320,-6.916278382,110.2095486
WONOTUNGGAL,10,1280,490,92,1862,66,289,503,858,2720,-7.025471037,109.756256
BANDAR,20,3819,1189,296,5304,325,1002,1695,3022,8326,-7.044650262,109.7969468
BLADO,30,2839,736,139,3714,218,858,1393,2469,6183,-7.119070077,109.8267991
REBAN,40,2203,623,137,2963,155,596,912,1663,4626,-7.107201835,109.8798533
BAWANG,50,2916,828,191,3935,195,650,1110,1955,5890,-7.128010508,109.9186178
TERSONO,60,1147,547,123,1817,53,211,559,823,2640,-7.03931427,109.9659012
GRINGSING,70,1608,673,230,2511,61,213,664,938,3449,-6.95700773,110.004154
LIMPUNG,80,1287,532,131,1950,81,256,603,940,2890,-7.019859109,109.9255292
BANYUPUTIH,81,1086,391,149,1626,54,221,506,781,2407,-6.960871624,109.9411709
SUBAH,90,1731,576,166,2473,114,351,823,1288,3761,-6.960011414,109.8744464
PECALUNGAN,91,1387,292,49,1728,164,519,784,1467,3195,-7.019633167,109.8612185
TULIS,100,1691,587,149,2427,82,385,723,1190,3617,-6.949896451,109.8112788
KANDEMAN,101,2079,895,203,3177,219,534,1097,1850,5027,-6.921084262,109.7735587
BATANG,110,1995,794,253,3042,99,336,791,1226,4268,-6.908433301,109.7292827
WARUNG ASEM,120,1269,503,112,1884,65,199,467,731,2615,-6.950846818,109.7068297
KANDANGSERANG,10,2383,645,183,3211,217,582,1026,1825,5036,-7.161781959,109.5325723
PANINGGARAN,20,3359,1005,371,4735,251,640,1218,2109,6844,-7.155062049,109.583873
LEBAKBARANG,30,569,189,59,817,51,136,235,422,1239,-7.132885705,109.6576911
PETUNGKRIONO,40,317,67,17,401,85,93,139,317,718,-7.153660519,109.7339386
TALUN,50,929,296,65,1290,95,242,406,743,2033,-7.044262911,109.7320623
DORO,60,1956,702,249,2907,203,484,880,1567,4474,-7.061036273,109.6869856
KARANGANYAR,70,1985,759,277,3021,181,426,938,1545,4566,-7.049098036,109.6271913
KAJEN,80,3363,1430,472,5265,120,604,1417,2141,7406,-7.059447694,109.5755036
KESESI,90,3901,1519,440,5860,222,724,1588,2534,8394,-7.026115277,109.5166959
SRAGI,100,3453,1318,403,5174,224,740,1496,2460,7634,-6.947787973,109.552773
SIWALAN,101,2263,852,424,3539,163,523,973,1659,5198,-6.889400072,109.5874036
BOJONG,110,3973,1417,461,5851,272,1004,1874,3150,9001,-6.972192962,109.582311
WONOPRINGGO,120,2173,824,294,3291,94,455,974,1523,4814,-6.991137164,109.6356119
KEDUNGWUNI,130,4201,1841,629,6671,212,682,1838,2732,9403,-6.965144318,109.6505576
KARANGDADAP,131,2477,1094,306,3877,101,477,1182,1760,5637,-6.978426742,109.6910169
BUARAN,140,2083,977,355,3415,48,237,851,1136,4551,-6.934270646,109.6581
TIRTO,150,3492,1366,471,5329,264,735,1600,2599,7928,-6.900910274,109.6370035
WIRADESA,160,2365,949,315,3629,110,456,1063,1629,5258,-6.906180294,109.6127145
WONOKERTO,161,1908,669,206,2783,167,471,922,1560,4343,-6.863508049,109.6250943
MOGA,10,4068,1167,286,5521,207,928,1459,2594,8115,-7.127207775,109.2421682
WARUNGPRING,11,2230,624,145,2999,137,383,495,1015,4014,-7.081194047,109.2638487
PULOSARI,20,3207,624,155,3986,237,878,1255,2370,6356,-7.189664351,109.2402384
BELIK,30,7354,1575,438,9367,593,1870,2806,5269,14636,-7.160704106,109.3362051
WATUKUMPUL,40,4451,901,257,5609,390,1148,1639,3177,8786,-7.160376706,109.4566568
BODEH,50,3318,960,178,4456,147,698,1367,2212,6668,-7.033232804,109.4769698
BANTARBOLANG,60,4179,1159,296,5634,338,996,1741,3075,8709,-7.044968136,109.3967692
RANDUDONGKAL,70,4110,1278,406,5794,396,847,1525,2768,8562,-7.056712986,109.3186029
PEMALANG,80,6191,1953,708,8852,372,1264,2548,4184,13036,-6.933193893,109.3643855
TAMAN,90,9050,3130,1194,13374,586,1749,3719,6054,19428,-6.908932526,109.4228003
PETARUKAN,100,9108,3090,1196,13394,595,1607,3652,5854,19248,-6.880864676,109.4717878
AMPELGADING,110,3556,1347,588,5491,198,569,1316,2083,7574,-6.948570084,109.4776686
COMAL,120,4586,1743,708,7037,357,721,1959,3037,10074,-6.884355597,109.5318525
ULUJAMI,130,6274,1980,588,8842,284,1205,2568,4057,12899,-6.840444053,109.540819
MARGASARI,10,5952,2121,746,8819,440,1101,2299,3840,12659,-7.098945385,109.0185912
BUMIJAWA,20,6689,1920,671,9280,614,1681,2477,4772,14052,-7.187271122,109.1252722
BOJONG,30,5420,1510,367,7297,490,1260,2046,3796,11093,-7.155562426,109.1768127
BALAPULANG,40,6029,2534,946,9509,278,653,2204,3135,12644,-7.083577885,109.1090176
PAGERBARANG,50,1680,828,419,2927,158,254,601,1013,3940,-7.015672622,109.0542797
LEBAKSIU,60,4319,1914,879,7112,343,609,1444,2396,9508,-7.031325519,109.1262814
JATINEGARA,70,3885,1350,516,5751,379,755,1453,2587,8338,-7.045927621,109.2269963
KEDUNG BANTENG,80,2527,1020,438,3985,351,523,943,1817,5802,-6.978241632,109.2256757
PANGKAH,90,5041,2501,1504,9046,218,323,1130,1671,10717,-6.989183783,109.164783
SLAWI,100,2431,1087,528,4046,117,232,704,1053,5099,-6.986517484,109.1336026
DUKUHWARU,110,2818,1132,313,4263,179,567,1034,1780,6043,-6.971831138,109.0965285
ADIWERNA,120,4257,1806,734,6797,252,736,1687,2675,9472,-6.936271411,109.110131
DUKUHTURI,130,3358,1485,669,5512,235,488,1186,1909,7421,-6.90184428,109.1072019
TALANG,140,3294,1101,341,4736,231,756,1481,2468,7204,-6.911438571,109.150381
TARUB,150,4372,1741,800,6913,323,613,1431,2367,9280,-6.924893737,109.1842668
KRAMAT,160,2669,1018,369,4056,195,489,1043,1727,5783,-6.880367711,109.1939733
SURADADI,170,3754,1551,691,5996,451,643,1585,2679,8675,-6.909847268,109.2570323
WARUREJA,180,3510,1195,336,5041,270,742,1404,2416,7457,-6.917011428,109.3162787
SALEM,10,3164,1078,257,4499,175,578,1216,1969,6468,-7.160652337,108.792519
BANTARKAWUNG,20,6797,2501,917,10215,690,1303,2483,4476,14691,-7.221648387,108.9142742
BUMIAYU,30,5228,2335,1082,8645,167,629,1763,2559,11204,-7.244410681,108.9854435
PAGUYANGAN,40,7179,2905,1049,11133,497,1131,2502,4130,15263,-7.291247857,109.0563708
SIRAMPOG,50,4050,1809,797,6656,170,355,1077,1602,8258,-7.231031355,109.0894774
TONJONG,60,4478,1887,838,7203,180,589,1551,2320,9523,-7.17433277,109.0176221
LARANGAN,70,7967,2367,665,10999,873,1896,3260,6029,17028,-7.03010019,108.9465796
KETANGGUNGAN,80,8788,2502,809,12099,868,2459,4383,7710,19809,-7.033454923,108.8836339
BANJARHARJO,90,5681,1415,288,7384,671,1874,3059,5604,12988,-7.022451521,108.8130659
LOSARI,100,8285,2672,880,11837,660,1955,3439,6054,17891,-6.866633806,108.8166055
TANJUNG,110,6723,2121,568,9412,623,1807,3275,5705,15117,-6.87399441,108.8625767
KERSANA,120,3245,888,269,4402,306,814,1126,2246,6648,-6.927863061,108.8637871
BULAKAMBA,130,10955,3201,1004,15160,1240,2947,5406,9593,24753,-6.879991769,108.9447587
WANASARI,140,9516,3145,1056,13717,811,2092,4153,7056,20773,-6.875131428,109.0066541
SONGGOM,150,5044,1683,470,7197,459,1132,2114,3705,10902,-7.004320914,109.0046147
JATIBARANG,160,4061,1312,322,5695,217,862,1567,2646,8341,-6.946134423,109.0519452
BREBES,170,8851,2874,947,12672,773,1953,3720,6446,19118,-6.844295227,109.0525146
MAGELANG SELATAN,10,978,464,284,1726,23,52,214,289,2015,-7.494797463,110.219552
MAGELANG TENGAH,11,1178,595,377,2150,26,65,251,342,2492,-7.477428775,110.2186729
MAGELANG UTARA,20,688,318,204,1210,8,15,121,144,1354,-7.456090414,110.2220824
LAWEYAN,10,2095,1113,710,3918,110,65,448,623,4541,-7.561327331,110.7932433
SERENGAN,20,1354,651,360,2365,31,66,340,437,2802,-7.581854991,110.8176566
PASAR KLIWON,30,2739,1281,735,4755,92,185,703,980,5735,-7.581051673,110.8316233
JEBRES,40,4213,2117,1287,7617,114,192,925,1231,8848,-7.554370313,110.8475175
BANJARSARI,50,5426,2693,1596,9715,201,240,1099,1540,11255,-7.547348016,110.8171754
ARGOMULYO,10,1017,482,259,1758,15,46,258,319,2077,-7.363809906,110.4988437
TINGKIR,20,716,387,268,1371,10,21,155,186,1557,-7.339311897,110.5191865
SIDOMUKTI,30,854,430,228,1512,24,41,192,257,1769,-7.335791226,110.4853609
SIDOREJO,40,844,423,235,1502,21,41,180,242,1744,-7.307202135,110.4937984
MIJEN,10,1256,664,366,2286,92,80,362,534,2820,-7.052926958,110.3160398
GUNUNG PATI,20,1749,864,450,3063,33,87,366,486,3549,-7.064888995,110.3753071
BANYUMANIK,30,1692,775,440,2907,54,67,355,476,3383,-7.069850507,110.4206347
GAJAH MUNGKUR,40,726,309,197,1232,9,19,90,118,1350,-7.012755525,110.4055963
SEMARANG SELATAN,50,1086,552,307,1945,30,39,207,276,2221,-6.996940591,110.4246208
CANDISARI,60,1347,618,349,2314,39,63,258,360,2674,-7.015915418,110.4276878
TEMBALANG,70,2658,1206,716,4580,109,175,593,877,5457,-7.048542011,110.4609956
PEDURUNGAN,80,2168,1048,574,3790,91,109,448,648,4438,-7.002234495,110.4739771
GENUK,90,1942,981,559,3482,60,98,505,663,4145,-6.96338054,110.476936
GAYAMSARI,100,1766,771,427,2964,98,115,391,604,3568,-6.979702913,110.4467485
SEMARANG TIMUR,110,1905,865,454,3224,86,130,436,652,3876,-6.972696963,110.4370826
SEMARANG UTARA,120,2778,1220,598,4596,100,198,670,968,5564,-6.958179665,110.4173103
SEMARANG TENGAH,130,1169,528,304,2001,30,63,270,363,2364,-6.980318054,110.4209895
SEMARANG BARAT,140,2682,1282,671,4635,100,109,478,687,5322,-6.978813896,110.384285
TUGU,150,364,181,121,666,16,26,90,132,798,-6.96189968,110.329889
NGALIYAN,160,1616,838,490,2944,43,53,257,353,3297,-7.000114438,110.3272504
PEKALONGAN BARAT,10,1692,848,314,2854,68,251,560,879,3733,-6.896489578,109.660152
PEKALONGAN TIMUR,20,1600,835,409,2844,66,218,559,843,3687,-6.894749902,109.6890964
PEKALONGAN SELATAN,30,1663,860,374,2897,58,187,532,777,3674,-6.919219738,109.6742821
PEKALONGAN UTARA,40,1355,660,288,2303,93,149,357,599,2902,-6.870858632,109.6847777
TEGAL SELATAN,10,1993,817,370,3180,154,278,576,1008,4188,-6.886451671,109.1223401
TEGAL TIMUR,20,2699,1162,547,4408,104,220,691,1015,5423,-6.863864128,109.1445497
TEGAL BARAT,30,2146,813,351,3310,93,287,657,1037,4347,-6.857537635,109.1162213
MARGADANA,40,1666,643,328,2637,66,232,492,790,3427,-6.873576253,109.0962233
TEMON,10,1095,502,248,1845,25,21,173,219,2064,-7.890003399,110.0723982
WATES,20,1798,817,428,3043,33,44,232,309,3352,-7.890738256,110.1318413
PANJATAN,30,1792,860,505,3157,24,38,288,350,3507,-7.917507959,110.1554868
GALUR,40,1283,561,354,2198,25,36,199,260,2458,-7.952871438,110.2016709
LENDAH,50,1871,849,449,3169,42,66,316,424,3593,-7.9139336,110.2312354
SENTOLO,60,2306,1032,544,3882,69,85,418,572,4454,-7.859709582,110.2198998
PENGASIH,70,2243,1122,606,3971,43,61,441,545,4516,-7.831176866,110.1554356
KOKAP,80,1776,885,482,3143,53,92,415,560,3703,-7.831197748,110.0962192
GIRIMULYO,90,1002,523,198,1723,35,53,213,301,2024,-7.751810468,110.1592879
NANGGULAN,100,1408,658,331,2397,20,53,246,319,2716,-7.787168291,110.2011878
KALIBAWANG,110,1485,749,412,2646,31,34,191,256,2902,-7.687212121,110.2322336
SAMIGALUH,120,1339,722,302,2363,44,46,225,315,2678,-7.681915053,110.1696026
SRANDAKAN,10,1506,647,474,2627,24,26,247,297,2924,-7.962231821,110.2404796
SANDEN,20,1551,690,464,2705,20,34,203,257,2962,-7.980816833,110.2656299
KRETEK,30,1286,595,378,2259,22,25,184,231,2490,-7.995130835,110.305177
PUNDONG,40,1875,848,523,3246,46,61,446,553,3799,-7.969856729,110.3421081
BAMBANG LIPURO,50,2063,813,534,3410,41,52,361,454,3864,-7.94432708,110.3134827
PANDAK,60,2919,1205,885,5009,39,76,490,605,5614,-7.92495395,110.2878306
BANTUL,70,2124,802,583,3509,51,55,340,446,3955,-7.895513274,110.3329439
JETIS,80,2229,998,645,3872,50,100,440,590,4462,-7.90996074,110.3662689
IMOGIRI,90,2430,1017,562,4009,42,179,609,830,4839,-7.938740625,110.3971511
DLINGO,100,2015,867,418,3300,58,148,588,794,4094,-7.920565378,110.4585076
PLERET,110,2069,845,480,3394,53,126,452,631,4025,-7.876850425,110.4141958
PIYUNGAN,120,2044,855,534,3433,73,77,342,492,3925,-7.84328713,110.4625206
BANGUNTAPAN,130,2855,1203,698,4756,23,114,501,638,5394,-7.829790575,110.4076196
SEWON,140,3078,1264,797,5139,41,97,518,656,5795,-7.857448129,110.356957
KASIHAN,150,3119,1273,726,5118,63,150,651,864,5982,-7.829218362,110.3235203
PAJANGAN,160,2217,929,591,3737,42,116,509,667,4404,-7.870438797,110.287231
SEDAYU,170,1942,727,541,3210,25,57,372,454,3664,-7.823598254,110.258638
PANGGANG,10,1376,625,241,2242,58,113,434,605,2847,-8.030923324,110.4400891
PURWOSARI,11,1147,504,242,1893,56,61,333,450,2343,-8.024969231,110.3764328
PALIYAN,20,1481,576,218,2275,54,131,400,585,2860,-8.013450386,110.5298054
SAPTO SARI,30,2428,997,319,3744,165,406,1091,1662,5406,-8.077351803,110.5099499
TEPUS,40,1158,508,134,1800,81,221,466,768,2568,-8.121333107,110.6564285
TANJUNGSARI,41,1151,499,201,1851,88,113,434,635,2486,-8.091956999,110.5898511
RONGKOP,50,1172,499,222,1893,64,88,337,489,2382,-8.087094309,110.7446659
GIRISUBO,51,1073,464,171,1708,51,133,405,589,2297,-8.166745094,110.7574801
SEMANU,60,1974,769,257,3000,84,199,642,925,3925,-8.032318277,110.6571904
PONJONG,70,2371,1139,513,4023,99,178,704,981,5004,-7.971800458,110.7301064
KARANGMOJO,80,2070,970,460,3500,73,142,525,740,4240,-7.93863569,110.6678929
WONOSARI,90,2255,949,450,3654,64,140,585,789,4443,-7.977100261,110.5908285
PLAYEN,100,2274,1113,541,3928,128,140,610,878,4806,-7.940810047,110.5225002
PATUK,110,1550,629,289,2468,137,128,381,646,3114,-7.861524624,110.5247829
GEDANG SARI,120,2772,1134,496,4402,103,242,706,1051,5453,-7.828960953,110.5936902
NGLIPAR,130,1676,831,384,2891,41,99,377,517,3408,-7.87459082,110.6334006
NGAWEN,140,1852,1032,610,3494,126,97,461,684,4178,-7.83123973,110.6918165
SEMIN,150,2863,1482,724,5069,140,183,725,1048,6117,-7.862153551,110.7427906
MOYUDAN,10,995,480,289,1764,20,23,159,202,1966,-7.777399772,110.2478479
MINGGIR,20,1167,579,334,2080,53,36,207,296,2376,-7.731753283,110.2485331
SEYEGAN,30,2117,985,584,3686,46,68,298,412,4098,-7.726564071,110.3003039
GODEAN,40,1891,878,520,3289,34,49,312,395,3684,-7.76806332,110.2955518
GAMPING,50,2291,1034,549,3874,50,101,464,615,4489,-7.789678964,110.320816
MLATI,60,1954,859,504,3317,39,67,313,419,3736,-7.739046806,110.3458324
DEPOK,70,1551,698,418,2667,32,38,242,312,2979,-7.766122937,110.4103392
BERBAH,80,1371,660,395,2426,28,49,236,313,2739,-7.806966881,110.4493227
PRAMBANAN,90,1868,826,449,3143,43,99,364,506,3649,-7.797366152,110.5046694
KALASAN,100,1763,841,455,3059,25,59,262,346,3405,-7.746884302,110.4639931
NGEMPLAK,110,902,406,237,1545,20,26,154,200,1745,-7.707030495,110.4438003
NGAGLIK,120,1753,799,478,3030,19,45,252,316,3346,-7.711967165,110.3993868
SLEMAN,130,2255,1069,541,3865,41,62,422,525,4390,-7.693429467,110.3493307
TEMPEL,140,1944,865,544,3353,37,51,295,383,3736,-7.66578624,110.3180222
TURI,150,1548,729,383,2660,36,48,290,374,3034,-7.62779963,110.3819262
PAKEM,160,910,444,250,1604,15,14,127,156,1760,-7.620382986,110.4184837
CANGKRINGAN,170,1238,533,252,2023,26,52,257,335,2358,-7.632326468,110.4504254
MANTRIJERON,10,866,373,206,1445,15,18,134,167,1612,-7.818834678,110.359065
KRATON,20,395,178,139,712,7,3,43,53,765,-7.80909177,110.3627278
MERGANGSAN,30,668,289,234,1191,18,20,83,121,1312,-7.813613052,110.3736096
UMBULHARJO,40,1286,539,361,2186,18,29,191,238,2424,-7.814095943,110.3870577
KOTAGEDE,50,713,308,213,1234,19,12,102,133,1367,-7.818730072,110.3987334
GONDOKUSUMAN,60,556,250,167,973,9,12,66,87,1060,-7.786242719,110.3817326
DANUREJAN,70,493,242,153,888,8,10,49,67,955,-7.793028667,110.3722545
PAKUALAMAN,80,160,84,43,287,2,6,22,30,317,-7.799959205,110.375465
GONDOMANAN,90,421,179,132,732,3,7,59,69,801,-7.801880334,110.3671445
NGAMPILAN,100,355,170,86,611,7,10,64,81,692,-7.800906456,110.3578935
WIROBRAJAN,110,755,320,194,1269,13,11,114,138,1407,-7.803254907,110.3504445
GEDONG TENGEN,120,566,246,146,958,17,23,96,136,1094,-7.791977437,110.3611379
JETIS,130,614,261,167,1042,15,14,71,100,1142,-7.782815231,110.3642492
TEGALREJO,140,1002,411,275,1688,16,28,138,182,1870,-7.778545939,110.3570048
DONOROJO,10,1069,424,130,1623,22,72,188,282,1905,-8.140752456,110.9478451
PUNUNG,20,496,239,86,821,23,37,145,205,1026,-8.112095663,111.037804
PRINGKUKU,30,612,234,103,949,13,41,154,208,1157,-8.190817673,111.0309934
PACITAN,40,769,299,138,1206,7,40,146,193,1399,-8.185821163,111.1061129
KEBONAGUNG,50,863,424,149,1436,41,74,287,402,1838,-8.220147172,111.1743212
ARJOSARI,60,1038,477,140,1655,28,138,381,547,2202,-8.098120844,111.1599603
NAWANGAN,70,2232,812,257,3301,72,232,700,1004,4305,-7.990106874,111.1831069
BANDAR,80,1627,633,164,2424,208,301,666,1175,3599,-7.998200807,111.2619481
TEGALOMBO,90,2643,1186,443,4272,124,389,968,1481,5753,-8.057594348,111.2988478
TULAKAN,100,3148,1330,381,4859,91,324,1019,1434,6293,-8.164238402,111.269356
NGADIROJO,110,1018,467,211,1696,34,68,268,370,2066,-8.200894726,111.324773
SUDIMORO,120,931,397,137,1465,27,103,350,480,1945,-8.223893561,111.374805
NGRAYUN,10,3504,1612,748,5864,182,301,1155,1638,7502,-8.107428466,111.4404317
SLAHUNG,20,1667,922,350,2939,43,127,560,730,3669,-8.024222899,111.3984975
BUNGKAL,30,926,421,179,1526,98,85,266,449,1975,-8.016115049,111.4645333
SAMBIT,40,1290,572,218,2080,60,98,310,468,2548,-8.001714191,111.5153353
SAWOO,50,2342,1104,440,3886,103,223,711,1037,4923,-7.981968868,111.5856204
SOOKO,60,619,326,190,1135,58,57,209,324,1459,-7.917969101,111.6559207
PUDAK,61,452,258,99,809,35,35,117,187,996,-7.859840517,111.7364423
PULUNG,70,1242,573,202,2017,43,115,481,639,2656,-7.864255419,111.6306761
MLARAK,80,975,541,270,1786,19,34,231,284,2070,-7.91914411,111.5236679
SIMAN,90,740,388,195,1323,22,36,175,233,1556,-7.889037599,111.5053245
JETIS,100,774,439,327,1540,68,38,122,228,1768,-7.942322272,111.4784373
BALONG,110,1624,782,468,2874,63,94,390,547,3421,-7.952849791,111.4122365
KAUMAN,120,1311,695,368,2374,70,68,427,565,2939,-7.886163228,111.4145611
JAMBON,130,2083,989,427,3499,78,204,662,944,4443,-7.927321123,111.3696275
BADEGAN,140,1600,787,380,2767,106,181,584,871,3638,-7.89878372,111.3196151
SAMPUNG,150,850,416,225,1491,75,95,241,411,1902,-7.823424094,111.3503636
SUKOREJO,160,1314,569,260,2143,40,68,289,397,2540,-7.825435194,111.4226699
PONOROGO,170,777,402,243,1422,76,52,126,254,1676,-7.866248255,111.4657052
BABADAN,180,641,304,184,1129,31,42,154,227,1356,-7.816155411,111.4770762
JENANGAN,190,989,428,206,1623,31,39,205,275,1898,-7.83020078,111.5466434
NGEBEL,200,904,290,66,1260,24,74,200,298,1558,-7.802451224,111.6451847
PANGGUL,10,3640,1601,473,5714,180,449,1159,1788,7502,-8.230123095,111.456672
MUNJUNGAN,20,1656,712,265,2633,138,257,560,955,3588,-8.297206837,111.5782498
WATULIMO,30,1196,464,159,1819,73,157,408,638,2457,-8.275263662,111.7022512
KAMPAK,40,1240,500,127,1867,49,151,403,603,2470,-8.201157237,111.6509551
DONGKO,50,3140,1216,364,4720,176,404,1237,1817,6537,-8.203998762,111.5652929
PULE,60,2134,877,210,3221,89,298,955,1342,4563,-8.117097451,111.5384131
KARANGAN,70,1158,572,198,1928,57,64,307,428,2356,-8.079170351,111.6717491
SURUH,71,977,406,130,1513,57,78,351,486,1999,-8.115960546,111.6194641
GANDUSARI,80,1176,555,191,1922,72,72,301,445,2367,-8.133968084,111.7102445
DURENAN,90,1072,513,198,1783,74,114,302,490,2273,-8.098737486,111.8022548
POGALAN,100,1418,647,260,2325,34,90,383,507,2832,-8.086246012,111.7534671
TRENGGALEK,110,1021,431,143,1595,39,68,269,376,1971,-8.032843734,111.7217907
TUGU,120,1543,759,360,2662,107,77,394,578,3240,-8.032776261,111.635206
BENDUNGAN,130,1275,550,111,1936,61,160,492,713,2649,-7.951104935,111.7068787
BESUKI,10,803,363,170,1336,107,51,194,352,1688,-8.230961658,111.7785582
BANDUNG,20,949,383,207,1539,87,73,269,429,1968,-8.166217984,111.7620729
PAKEL,30,1759,712,282,2753,50,107,483,640,3393,-8.151970253,111.8299446
CAMPUR DARAT,40,1502,652,252,2406,104,112,433,649,3055,-8.166583356,111.862745
TANGGUNG GUNUNG,50,761,326,121,1208,61,79,209,349,1557,-8.236572053,111.8841728
KALIDAWIR,60,1626,681,253,2560,104,146,454,704,3264,-8.198728748,111.9487015
PUCANG LABAN,70,516,198,23,737,39,81,230,350,1087,-8.241400677,112.0020144
REJOTANGAN,80,1449,580,220,2249,57,137,408,602,2851,-8.145041108,112.0641733
NGUNUT,90,1601,654,293,2548,71,119,416,606,3154,-8.116343415,111.9978238
SUMBERGEMPOL,100,1617,717,288,2622,107,135,411,653,3275,-8.101137369,111.9542673
BOYOLANGU,110,1915,870,439,3224,69,86,405,560,3784,-8.104175031,111.8999074
TULUNGAGUNG,120,1081,516,319,1916,36,44,159,239,2155,-8.071112508,111.9008717
KEDUNGWARU,130,2448,1076,536,4060,104,156,643,903,4963,-8.044156526,111.9233936
NGANTRU,140,1537,543,252,2332,112,118,437,667,2999,-8.012201666,111.9483896
KARANGREJO,150,1194,455,199,1848,84,123,285,492,2340,-7.994213571,111.8918409
KAUMAN,160,1162,509,252,1923,65,89,321,475,2398,-8.037587985,111.8585406
GONDANG,170,1310,597,253,2160,42,87,393,522,2682,-8.070674571,111.8332173
PAGER WOJO,180,1105,393,107,1605,95,166,419,680,2285,-7.976704897,111.7841891
SENDANG,190,1831,674,192,2697,115,268,608,991,3688,-7.927933429,111.8303431
BAKUNG,10,495,218,74,787,36,72,203,311,1098,-8.271844562,112.0744946
WONOTIRTO,20,647,244,53,944,78,125,294,497,1441,-8.26474482,112.1748083
PANGGUNGREJO,30,959,299,104,1362,82,135,301,518,1880,-8.266598272,112.2630547
WATES,40,762,328,74,1164,44,123,308,475,1639,-8.293062476,112.3392167
BINANGUN,50,1162,540,161,1863,53,147,492,692,2555,-8.208298678,112.3377383
SUTOJAYAN,60,965,380,152,1497,53,58,257,368,1865,-8.177792379,112.2266929
KADEMANGAN,70,1237,647,384,2268,198,161,460,819,3087,-8.187754998,112.1055338
KANIGORO,80,2072,837,298,3207,98,163,509,770,3977,-8.124336422,112.2079763
TALUN,90,1257,538,212,2007,85,118,354,557,2564,-8.099607609,112.2736004
SELOPURO,100,1498,709,317,2524,81,134,390,605,3129,-8.137726246,112.3113439
KESAMBEN,110,1386,619,223,2228,160,112,324,596,2824,-8.125989417,112.3805443
SELOREJO,120,837,310,82,1229,47,87,203,337,1566,-8.100006283,112.4351994
DOKO,130,562,220,80,862,126,87,196,409,1271,-8.039769846,112.405505
WLINGI,140,1719,685,264,2668,66,162,399,627,3295,-8.015756386,112.38355
GANDUSARI,150,2249,768,208,3225,128,402,792,1322,4547,-7.994250271,112.3335818
GARUM,160,2312,811,294,3417,104,209,532,845,4262,-8.034960229,112.2467791
NGLEGOK,170,1338,514,213,2065,160,241,434,835,2900,-7.998992371,112.2191599
SANANKULON,180,2213,942,432,3587,125,149,548,822,4409,-8.08823886,112.1423158
PONGGOK,190,2892,993,251,4136,222,485,1123,1830,5966,-8.021208441,112.1203008
SRENGAT,200,1817,826,310,2953,91,122,599,812,3765,-8.083561393,112.0703726
WONODADI,210,1196,483,144,1823,99,144,470,713,2536,-8.05276166,112.0055076
UDANAWU,220,1160,462,192,1814,71,91,383,545,2359,-8.014218163,112.0324665
MOJO,10,2600,883,288,3771,235,605,1131,1971,5742,-7.895837426,111.9057865
SEMEN,20,1955,732,251,2938,132,283,599,1014,3952,-7.836880453,111.9005254
NGADILUWIH,30,1824,790,398,3012,128,108,450,686,3698,-7.897061423,111.9954011
KRAS,40,1470,574,293,2337,71,104,346,521,2858,-7.963098682,111.9770088
RINGINREJO,50,1532,625,205,2362,105,190,468,763,3125,-7.974999595,112.0472999
KANDAT,60,1763,735,318,2816,75,136,488,699,3515,-7.920447961,112.0429823
WATES,70,3316,1322,575,5213,169,272,808,1249,6462,-7.903575915,112.0996134
NGANCAR,80,1459,511,154,2124,238,288,541,1067,3191,-7.940503007,112.1857609
PLOSOKLATEN,90,2140,953,417,3510,278,246,592,1116,4626,-7.871035044,112.1820955
GURAH,100,2286,854,381,3521,96,122,478,696,4217,-7.818058867,112.1096289
PUNCU,110,2231,908,314,3453,124,242,710,1076,4529,-7.849642813,112.2409411
KEPUNG,120,3240,1310,415,4965,143,333,900,1376,6341,-7.826171199,112.280603
KANDANGAN,130,1752,751,313,2816,79,145,483,707,3523,-7.752199282,112.3022811
PARE,140,3005,1223,588,4816,163,290,789,1242,6058,-7.778513352,112.1731032
BADAS,141,2440,1031,434,3905,214,224,727,1165,5070,-7.726052927,112.2099848
KUNJANG,150,1167,507,219,1893,97,108,392,597,2490,-7.662477736,112.178658
PLEMAHAN,160,2113,847,375,3335,206,200,632,1038,4373,-7.705830704,112.153586
PURWOASRI,170,2150,968,461,3579,91,140,500,731,4310,-7.637635196,112.1261974
PAPAR,180,2327,979,451,3757,43,142,594,779,4536,-7.705580651,112.0891031
PAGU,190,998,469,263,1730,64,66,253,383,2113,-7.778254411,112.0814097
KAYEN KIDUL,191,1409,576,268,2253,219,170,442,831,3084,-7.743691819,112.1022648
GAMPENGREJO,200,727,288,154,1169,56,48,162,266,1435,-7.763356309,112.0337852
NGASEM,201,1281,506,257,2044,187,123,279,589,2633,-7.803550054,112.0476241
BANYAKAN,210,1867,787,262,2916,91,238,597,926,3842,-7.790337185,111.9236683
GROGOL,220,1882,795,322,2999,147,205,581,933,3932,-7.758004167,111.9368113
TAROKAN,230,2994,1160,356,4510,189,424,1092,1705,6215,-7.727675825,111.9380885
DONOMULYO,10,1780,736,251,2767,206,239,569,1014,3781,-8.325079869,112.430155
KALIPARE,20,1870,649,198,2717,51,142,451,644,3361,-8.212497679,112.4381855
PAGAK,30,1064,295,61,1420,136,336,393,865,2285,-8.245746569,112.518017
BANTUR,40,2126,713,180,3019,117,353,693,1163,4182,-8.314127927,112.5523333
GEDANGAN,50,2220,838,283,3341,115,273,678,1066,4407,-8.343331072,112.6219906
SUMBERMANJING,60,3001,961,248,4210,224,468,890,1582,5792,-8.340926995,112.7141872
DAMPIT,70,3663,1139,263,5065,199,552,1078,1829,6894,-8.241969801,112.7677342
TIRTO YUDO,80,2553,753,121,3427,123,405,781,1309,4736,-8.279571987,112.8367884
AMPELGADING,90,2127,602,139,2868,82,299,500,881,3749,-8.248224536,112.8900821
PONCOKUSUMO,100,3274,1071,218,4563,511,1034,1702,3247,7810,-8.0430552,112.8409044
WAJAK,110,2375,706,186,3267,339,643,981,1963,5230,-8.121065031,112.7689099
TUREN,120,2279,815,265,3359,123,314,699,1136,4495,-8.177702407,112.6921443
BULULAWANG,130,1850,776,309,2935,81,178,510,769,3704,-8.101679394,112.6512576
GONDANGLEGI,140,2173,866,293,3332,179,333,670,1182,4514,-8.157841017,112.6339782
PAGELARAN,150,2102,847,255,3204,118,297,583,998,4202,-8.198951468,112.6042459
KEPANJEN,160,2104,871,292,3267,48,184,565,797,4064,-8.132567058,112.5717689
SUMBER PUCUNG,170,1269,576,239,2084,41,144,318,503,2587,-8.165770647,112.4937316
KROMENGAN,180,774,329,177,1280,53,61,184,298,1578,-8.12330578,112.4908878
NGAJUM,190,1561,536,148,2245,156,271,576,1003,3248,-8.056239389,112.5342512
WONOSARI,200,1424,596,280,2300,130,145,334,609,2909,-8.063901491,112.4929879
WAGIR,210,1375,424,144,1943,134,353,535,1022,2965,-8.00080192,112.5586217
PAKISAJI,220,1471,548,233,2252,142,171,369,682,2934,-8.056796807,112.5976386
TAJINAN,230,1401,489,182,2072,119,289,519,927,2999,-8.059760633,112.6809394
TUMPANG,240,2400,725,191,3316,185,546,951,1682,4998,-8.011162938,112.758795
PAKIS,250,2977,1087,433,4497,183,385,794,1362,5859,-7.960260702,112.7053488
JABUNG,260,1819,566,330,2715,219,402,661,1282,3997,-7.946057362,112.7892385
LAWANG,270,1304,518,192,2014,95,196,441,732,2746,-7.844483977,112.7011738
SINGOSARI,280,1888,685,328,2901,257,394,669,1320,4221,-7.865023706,112.6542462
KARANGPLOSO,290,1620,636,280,2536,156,204,510,870,3406,-7.859856334,112.5928008
DAU,300,800,326,239,1365,114,82,146,342,1707,-7.949802336,112.5354761
PUJON,310,2506,722,160,3388,200,610,1032,1842,5230,-7.840642409,112.4458291
NGANTANG,320,2049,759,252,3060,164,335,725,1224,4284,-7.889551706,112.371374
KASEMBON,330,1457,645,246,2348,125,149,399,673,3021,-7.80639221,112.3375715
TEMPURSARI,10,975,350,125,1450,77,125,298,500,1950,-8.286149675,112.9724631
PRONOJIWO,20,1017,267,47,1331,110,216,315,641,1972,-8.187063272,112.9562853
CANDIPURO,30,2040,747,374,3161,285,302,614,1201,4362,-8.185700744,113.0495366
PASIRIAN,40,2842,946,315,4103,228,416,932,1576,5679,-8.243871341,113.1122785
TEMPEH,50,3142,1238,375,4755,280,518,1260,2058,6813,-8.213037826,113.1783218
LUMAJANG,60,1843,790,430,3063,104,163,402,669,3732,-8.134631449,113.2350814
SUMBERSUKO,61,875,343,162,1380,81,123,321,525,1905,-8.153705392,113.1862311
TEKUNG,70,977,297,130,1404,30,144,306,480,1884,-8.176686293,113.2583536
KUNIR,80,1811,597,238,2646,185,356,632,1173,3819,-8.222770243,113.230921
YOSOWILANGUN,90,1804,679,233,2716,132,256,598,986,3702,-8.254475648,113.2834199
ROWOKANGKUNG,100,1525,483,245,2253,140,234,460,834,3087,-8.181300526,113.3182708
JATIROTO,110,1876,654,235,2765,252,313,668,1233,3998,-8.130775718,113.3315537
RANDUAGUNG,120,2175,794,354,3323,434,486,830,1750,5073,-8.055578236,113.3179436
SUKODONO,130,1854,736,340,2930,102,206,554,862,3792,-8.105991416,113.2358446
PADANG,140,1224,356,109,1689,180,275,484,939,2628,-8.09444807,113.1743148
PASRUJAMBE,150,835,252,81,1168,97,211,268,576,1744,-8.091870582,113.0056911
SENDURO,160,1546,342,166,2054,334,431,684,1449,3503,-8.035128553,113.0383718
GUCIALIT,170,749,241,47,1037,305,242,416,963,2000,-8.022937632,113.140429
KEDUNGJAJANG,180,1824,502,311,2637,340,439,573,1352,3989,-8.039561711,113.2235374
KLAKAH,190,2145,692,318,3155,394,411,611,1416,4571,-7.99935471,113.2594074
RANUYOSO,200,2194,705,291,3190,360,512,776,1648,4838,-7.947835485,113.2633451
KENCONG,10,1573,561,182,2316,96,225,520,841,3157,-8.285629163,113.3570074
GUMUK MAS,20,1849,619,213,2681,143,293,621,1057,3738,-8.3279328,113.4031245
PUGER,30,2621,884,294,3799,144,388,820,1352,5151,-8.403880188,113.4027219
WULUHAN,40,2622,1086,435,4143,291,369,739,1399,5542,-8.357008924,113.5383894
AMBULU,50,2611,1044,499,4154,268,273,625,1166,5320,-8.381265194,113.6069003
TEMPUREJO,60,3371,1149,364,4884,338,596,1052,1986,6870,-8.411842009,113.7639085
SILO,70,4218,1189,436,5843,714,1026,1414,3154,8997,-8.26454187,113.8747912
MAYANG,80,2580,912,328,3820,207,371,750,1328,5148,-8.203717664,113.8010874
MUMBULSARI,90,3623,1037,418,5078,405,978,1322,2705,7783,-8.257093711,113.7411958
JENGGAWAH,100,2857,1056,501,4414,268,425,885,1578,5992,-8.290949687,113.6462845
AJUNG,110,2836,1069,517,4422,323,419,900,1642,6064,-8.236720588,113.6544613
RAMBIPUJI,120,2238,869,346,3453,147,289,618,1054,4507,-8.231520521,113.5970284
BALUNG,130,1902,772,339,3013,168,286,493,947,3960,-8.270607285,113.5283961
UMBULSARI,140,2032,802,276,3110,130,264,650,1044,4154,-8.241590239,113.4387678
SEMBORO,150,1326,497,212,2035,193,198,404,795,2830,-8.182558009,113.4376297
JOMBANG,160,1014,438,225,1677,132,193,320,645,2322,-8.222122367,113.3591303
SUMBER BARU,170,5654,1581,689,7924,821,1232,1846,3899,11823,-8.080322617,113.4060682
TANGGUL,180,3333,1102,458,4893,310,605,993,1908,6801,-8.096073144,113.4984043
BANGSALSARI,190,4407,1497,581,6485,419,839,1407,2665,9150,-8.149811229,113.5516794
PANTI,200,2521,960,523,4004,289,320,591,1200,5204,-8.070329895,113.6228432
SUKORAMBI,210,1819,613,331,2763,111,194,454,759,3522,-8.116922583,113.6617403
ARJASA,220,2112,681,220,3013,254,375,723,1352,4365,-8.101318827,113.7320574
PAKUSARI,230,1998,687,316,3001,194,317,522,1033,4034,-8.157393219,113.7695368
KALISAT,240,4164,1393,572,6129,329,581,1143,2053,8182,-8.122976836,113.8069411
LEDOKOMBO,250,3846,1061,438,5345,461,864,1302,2627,7972,-8.141307796,113.9149647
SUMBERJAMBE,260,3593,1002,414,5009,520,710,1132,2362,7371,-8.078587652,113.9348694
SUKOWONO,270,3482,1096,481,5059,272,566,1080,1918,6977,-8.06724695,113.8316332
JELBUK,280,1945,547,236,2728,242,377,646,1265,3993,-8.053845728,113.7239665
KALIWATES,710,2134,863,389,3386,105,175,514,794,4180,-8.18469897,113.6760956
SUMBERSARI,720,1849,616,246,2711,158,302,613,1073,3784,-8.177976629,113.7279873
PATRANG,730,2808,1085,479,4372,187,362,731,1280,5652,-8.135358069,113.699808
PESANGGARAN,10,1955,797,302,3054,108,239,482,829,3883,-8.519866954,113.9721472
SILIRAGUNG,11,1313,555,236,2104,58,111,274,443,2547,-8.511753683,114.0972068
BANGOREJO,20,2461,1082,519,4062,82,134,522,738,4800,-8.535385277,114.1743124
PURWOHARJO,30,2006,809,363,3178,88,137,413,638,3816,-8.536116424,114.2411743
TEGALDLIMO,40,1263,586,226,2075,26,84,302,412,2487,-8.648136609,114.4270414
MUNCAR,50,2763,1041,384,4188,114,316,916,1346,5534,-8.446663439,114.3186841
CLURING,60,2178,977,471,3626,58,141,535,734,4360,-8.435220101,114.2321071
GAMBIRAN,70,2171,993,442,3606,54,111,463,628,4234,-8.41175607,114.1672072
TEGALSARI,71,1432,579,278,2289,38,89,313,440,2729,-8.421526926,114.1256238
GLENMORE,80,3027,1162,498,4687,158,275,608,1041,5728,-8.312219343,114.0484768
KALIBARU,90,2643,805,330,3778,233,388,622,1243,5021,-8.270516185,113.9791001
GENTENG,100,3865,1648,785,6298,99,232,786,1117,7415,-8.347209893,114.1482433
SRONO,110,2213,1101,471,3785,132,241,620,993,4778,-8.377917495,114.26037
ROGOJAMPI,120,2466,985,387,3838,166,331,637,1134,4972,-8.333982479,114.3106038
KABAT,130,2228,742,204,3174,147,407,646,1200,4374,-8.270374171,114.3107309
SINGOJURUH,140,1313,506,155,1974,57,173,387,617,2591,-8.306106812,114.2330995
SEMPU,150,2039,913,441,3393,70,151,446,667,4060,-8.281979398,114.1519549
SONGGON,160,2426,895,306,3627,94,235,550,879,4506,-8.186259326,114.1571939
GLAGAH,170,846,289,95,1230,80,141,270,491,1721,-8.196213144,114.2994928
LICIN,171,1276,409,137,1822,81,188,305,574,2396,-8.158561486,114.2363568
BANYUWANGI,180,2748,1094,614,4456,156,213,537,906,5362,-8.228592872,114.3680029
GIRI,190,664,273,110,1047,37,71,158,266,1313,-8.192399793,114.3349878
KALIPURO,200,1983,685,271,2939,178,236,454,868,3807,-8.11646486,114.3336202
WONGSOREJO,210,2432,804,335,3571,241,324,602,1167,4738,-7.989243598,114.3328125
MAESAN,10,2439,794,359,3592,216,264,583,1063,4655,-8.018548511,113.7476117
GRUJUGAN,20,2392,895,434,3721,155,252,456,863,4584,-7.977539204,113.7524419
TAMANAN,30,2352,723,319,3394,190,354,581,1125,4519,-8.020707051,113.8295178
JAMBESARI DARUS SHOLAH,31,2215,819,377,3411,115,214,492,821,4232,-7.989854029,113.8521172
PUJER,40,2406,930,454,3790,174,264,495,933,4723,-7.982694694,113.8891457
TLOGOSARI,50,2897,1079,630,4606,329,432,656,1417,6023,-8.032989678,113.9773595
SUKOSARI,60,982,383,172,1537,49,78,199,326,1863,-7.940899772,113.9528239
SUMBER WRINGIN,61,2183,744,303,3230,158,207,404,769,3999,-8.003525087,114.0307313
TAPEN,70,1608,596,274,2478,100,113,253,466,2944,-7.884897941,113.9381595
WONOSARI,80,1949,798,413,3160,137,123,325,585,3745,-7.917072588,113.8985189
TENGGARANG,90,1586,735,337,2658,99,122,286,507,3165,-7.93476144,113.8501932
BONDOWOSO,100,1635,760,406,2801,166,111,246,523,3324,-7.92929119,113.8191854
CURAH DAMI,110,1832,709,370,2911,81,137,297,515,3426,-7.931537246,113.773512
BINAKAL,111,1129,433,193,1755,34,85,218,337,2092,-7.910767241,113.7403219
PAKEM,120,1599,562,209,2370,91,176,297,564,2934,-7.910465058,113.7008477
WRINGIN,130,2135,773,257,3165,135,262,470,867,4032,-7.829059162,113.7740138
TEGALAMPEL,140,1031,331,123,1485,101,157,250,508,1993,-7.87301373,113.8220453
TAMAN KROCOK,141,642,208,60,910,70,116,200,386,1296,-7.851603595,113.8678982
KLABANG,150,469,174,149,792,78,51,55,184,976,-7.828096828,113.9220743
SEMPOL,151,541,180,39,760,14,33,116,163,923,-8.047977923,114.162506
BOTOLINGGO,152,1411,446,151,2008,247,265,351,863,2871,-7.910576097,114.0388436
PRAJEKAN,160,921,402,298,1621,121,65,81,267,1888,-7.81226349,113.999007
CERMEE,170,2681,981,424,4086,298,294,509,1101,5187,-7.849388925,114.0688634
SUMBERMALANG,10,1357,480,159,1996,210,278,423,911,2907,-7.882316067,113.6763589
JATIBANTENG,20,774,248,95,1117,158,195,310,663,1780,-7.823878467,113.6517552
BANYUGLUGUR,30,755,353,157,1265,163,118,175,456,1721,-7.752382277,113.6263511
BESUKI,40,2181,963,526,3670,213,237,561,1011,4681,-7.754474022,113.7022962
SUBOH,50,1159,480,228,1867,140,180,298,618,2485,-7.766411429,113.7315081
MLANDINGAN,60,681,275,144,1100,116,92,119,327,1427,-7.778024437,113.7910214
BUNGATAN,70,641,324,212,1177,125,70,141,336,1513,-7.73574107,113.8288562
KENDIT,80,715,271,142,1128,107,153,203,463,1591,-7.745977962,113.9052599
PANARUKAN,90,833,323,183,1339,138,110,170,418,1757,-7.696545273,113.9743664
SITUBONDO,100,1009,463,274,1746,64,81,212,357,2103,-7.722414602,113.9958424
MANGARAN,110,941,358,158,1457,61,154,289,504,1961,-7.642565483,114.0419171
PANJI,120,1571,703,322,2596,129,204,361,694,3290,-7.716735422,114.0338248
KAPONGAN,130,858,358,149,1365,119,138,252,509,1874,-7.710024646,114.0775431
ARJASA,140,1009,295,124,1428,212,253,316,781,2209,-7.84377734,114.1268717
JANGKAR,150,961,289,119,1369,116,190,274,580,1949,-7.772602633,114.1694146
ASEMBAGUS,160,1010,413,240,1663,114,137,267,518,2181,-7.863508021,114.21192
BANYUPUTIH,170,1509,589,245,2343,162,256,363,781,3124,-7.830647324,114.3457934
SUKAPURA,10,668,189,49,906,58,137,226,421,1327,-7.921429949,113.0097499
SUMBER,20,1289,233,59,1581,234,340,469,1043,2624,-7.954718026,113.0886038
KURIPAN,30,1915,441,207,2563,469,524,741,1734,4297,-7.901802243,113.1383498
BANTARAN,40,2056,577,188,2821,262,423,694,1379,4200,-7.870056792,113.1900211
LECES,50,2719,815,359,3893,196,372,727,1295,5188,-7.861922224,113.2289686
TEGALSIWALAN,60,1561,453,172,2186,97,269,473,839,3025,-7.866905945,113.2663079
BANYUANYAR,70,2773,1042,480,4295,165,319,717,1201,5496,-7.861591691,113.3089424
TIRIS,80,3918,1233,449,5600,374,774,1329,2477,8077,-7.951824768,113.3835668
KRUCIL,90,4120,1036,348,5504,401,670,1157,2228,7732,-7.942595695,113.5078604
GADING,100,3194,1081,442,4717,121,251,700,1072,5789,-7.869411915,113.4982458
PAKUNIRAN,110,2115,995,436,3546,81,178,557,816,4362,-7.823251474,113.5518509
KOTAANYAR,120,1867,838,481,3186,113,149,397,659,3845,-7.764193647,113.5563369
PAITON,130,2334,1075,553,3962,86,143,481,710,4672,-7.727137766,113.5164566
BESUK,140,2508,1101,484,4093,91,177,565,833,4926,-7.789406134,113.4778991
KRAKSAAN,150,2941,1117,533,4591,129,224,646,999,5590,-7.755833869,113.4301498
KREJENGAN,160,2244,864,430,3538,56,103,401,560,4098,-7.800404638,113.4156901
PAJARAKAN,170,1481,568,269,2318,55,85,359,499,2817,-7.7740859,113.3728998
MARON,180,3532,1454,602,5588,142,295,892,1329,6917,-7.841807872,113.3600705
GENDING,190,1941,849,340,3130,89,157,430,676,3806,-7.79502554,113.312824
DRINGU,200,2026,687,295,3008,109,222,481,812,3820,-7.7878958,113.2551913
WONOMERTO,210,1540,415,130,2085,150,375,584,1109,3194,-7.828615962,113.1503316
LUMBANG,220,1815,420,109,2344,226,505,658,1389,3733,-7.845104231,113.0583327
TONGAS,230,3317,824,270,4411,394,780,1189,2363,6774,-7.761458801,113.0935959
SUMBERASIH,240,3012,1114,488,4614,219,393,828,1440,6054,-7.767506535,113.1573528
PURWODADI,10,2034,746,280,3060,184,320,686,1190,4250,-7.807977266,112.7173314
TUTUR,20,990,361,184,1535,129,194,315,638,2173,-7.878966876,112.8225686
PUSPO,30,1749,410,121,2280,131,403,593,1127,3407,-7.851781561,112.8875046
TOSARI,40,663,181,46,890,68,88,160,316,1206,-7.899638403,112.9038271
LUMBANG,50,1801,458,172,2431,153,397,664,1214,3645,-7.818979244,112.9854497
PASREPAN,60,2290,597,184,3071,429,825,1021,2275,5346,-7.791926789,112.8735615
KEJAYAN,70,2244,831,370,3445,454,498,741,1693,5138,-7.739598333,112.8437552
WONOREJO,80,2899,1117,538,4554,375,540,938,1853,6407,-7.715976282,112.789516
PURWOSARI,90,2068,901,314,3283,107,247,721,1075,4358,-7.761383472,112.7264299
PRIGEN,100,932,409,143,1484,61,126,278,465,1949,-7.707676168,112.6402157
SUKOREJO,110,1297,683,437,2417,204,153,336,693,3110,-7.693774573,112.7302542
PANDAAN,120,904,502,332,1738,116,106,188,410,2148,-7.649760305,112.7068488
GEMPOL,130,1447,756,433,2636,185,165,430,780,3416,-7.594877041,112.6810563
BEJI,140,1669,876,522,3067,125,163,431,719,3786,-7.599262897,112.7440264
BANGIL,150,1166,531,386,2083,59,50,190,299,2382,-7.586185915,112.8101859
REMBANG,160,2229,818,372,3419,205,464,837,1506,4925,-7.645916654,112.7962307
KRATON,170,3247,1392,846,5485,625,523,799,1947,7432,-7.644212353,112.8520139
POHJENTREK,180,1042,364,214,1620,166,252,367,785,2405,-7.663870104,112.8711713
GONDANG WETAN,190,2210,989,457,3656,134,278,600,1012,4668,-7.708754857,112.9117404
REJOSO,200,1768,723,354,2845,257,279,551,1087,3932,-7.67983351,112.950612
WINONGAN,210,2932,1029,444,4405,287,531,885,1703,6108,-7.74921357,112.9441587
GRATI,220,4101,1571,738,6410,343,747,1418,2508,8918,-7.738145905,113.0024914
LEKOK,230,4319,1379,716,6414,659,985,1357,3001,9415,-7.675530791,113.0085498
NGULING,240,2922,1342,852,5116,379,470,696,1545,6661,-7.718375193,113.0532163
TARIK,10,3141,1613,1069,5823,114,113,610,837,6660,-7.447576201,112.5157516
PRAMBON,20,2182,1083,687,3952,68,131,647,846,4798,-7.464531866,112.5846726
KREMBUNG,30,2731,1315,850,4896,68,77,513,658,5554,-7.515669428,112.6382829
PORONG,40,2417,1021,660,4098,77,71,502,650,4748,-7.528650453,112.7058078
JABON,50,2261,1128,603,3992,110,108,566,784,4776,-7.544672142,112.7971731
TANGGULANGIN,60,1648,903,548,3099,56,65,389,510,3609,-7.507055556,112.7226554
CANDI,70,1845,987,533,3365,47,81,477,605,3970,-7.48349788,112.7300698
TULANGAN,80,2158,1124,801,4083,119,82,437,638,4721,-7.475119262,112.6444331
WONOAYU,90,1983,972,637,3592,59,120,484,663,4255,-7.429341855,112.6302423
SUKODONO,100,1406,703,467,2576,80,65,321,466,3042,-7.398850032,112.6735586
SIDOARJO,110,2225,1048,685,3958,86,76,347,509,4467,-7.465124714,112.7473366
BUDURAN,120,1611,782,454,2847,75,71,281,427,3274,-7.435753579,112.7591682
SEDATI,130,1349,704,369,2422,96,93,367,556,2978,-7.400479691,112.8035699
WARU,140,2591,1143,681,4415,100,86,428,614,5029,-7.354461924,112.7665164
GEDANGAN,150,1193,613,391,2197,74,60,258,392,2589,-7.391534168,112.729733
TAMAN,160,3210,1637,1119,5966,66,97,526,689,6655,-7.365907619,112.6732031
KRIAN,170,3729,1820,1173,6722,232,199,840,1271,7993,-7.399685876,112.5956539
BALONG BENDO,180,2680,1299,867,4846,147,179,666,992,5838,-7.4191898,112.528063
JATIREJO,10,1856,806,285,2947,53,167,627,847,3794,-7.65128647,112.4334282
GONDANG,20,1433,636,228,2297,51,162,433,646,2943,-7.676832644,112.4824909
PACET,30,1573,730,235,2538,43,131,524,698,3236,-7.670839008,112.5431553
TRAWAS,40,1108,538,195,1841,24,91,286,401,2242,-7.642811108,112.5942382
NGORO,50,2697,1247,603,4547,205,295,748,1248,5795,-7.565623982,112.6200251
PUNGGING,60,1983,1019,627,3629,67,73,380,520,4149,-7.536454726,112.5713288
KUTOREJO,70,2135,928,424,3487,85,235,772,1092,4579,-7.5631931,112.5211002
MOJOSARI,80,1913,962,541,3416,129,110,495,734,4150,-7.505305191,112.542661
BANGSAL,90,1544,703,329,2576,22,66,350,438,3014,-7.506100326,112.4994075
MOJOANYAR,91,1158,628,361,2147,85,48,317,450,2597,-7.475117007,112.4810222
DLANGGU,100,2004,926,448,3378,94,117,530,741,4119,-7.570834373,112.4768085
PURI,110,2351,1124,500,3975,52,160,680,892,4867,-7.529715783,112.4457668
TROWULAN,120,2308,950,433,3691,136,203,705,1044,4735,-7.549260833,112.3897112
SOOKO,130,2204,1049,533,3786,49,127,545,721,4507,-7.501641392,112.4099738
GEDEK,140,1541,770,359,2670,104,84,358,546,3216,-7.443253654,112.4013658
KEMLAGI,150,2060,922,418,3400,43,145,556,744,4144,-7.401151941,112.3688186
JETIS,160,1590,776,324,2690,101,189,509,799,3489,-7.404729179,112.4454892
DAWAR BLANDONG,170,1713,760,307,2780,66,134,494,694,3474,-7.344012994,112.4210599
BANDAR KEDUNG MULYO,10,1903,902,557,3362,116,89,394,599,3961,-7.567619851,112.1397191
PERAK,20,2061,978,413,3452,153,136,488,777,4229,-7.571610391,112.1723694
GUDO,30,1945,929,421,3295,85,117,469,671,3966,-7.626312809,112.1995184
DIWEK,40,4246,1928,1005,7179,81,189,829,1099,8278,-7.599188702,112.2350058
NGORO,50,3228,1305,574,5107,95,228,701,1024,6131,-7.678752588,112.2513326
MOJOWARNO,60,4733,1974,833,7540,148,396,1412,1956,9496,-7.620400532,112.3121491
BARENG,70,2515,901,309,3725,86,308,758,1152,4877,-7.690911674,112.3143701
WONOSALAM,80,1829,670,199,2698,85,207,528,820,3518,-7.713967947,112.3898934
MOJOAGUNG,90,3538,1436,603,5577,86,281,981,1348,6925,-7.589745957,112.3610651
SUMOBITO,100,3991,1765,664,6420,91,275,987,1353,7773,-7.522245283,112.3284321
JOGO ROTO,110,3345,1524,766,5635,73,203,800,1076,6711,-7.57239022,112.2784879
PETERONGAN,120,2250,1052,430,3732,75,155,564,794,4526,-7.514681167,112.2759773
JOMBANG,130,2362,1133,597,4092,82,126,493,701,4793,-7.537168971,112.2211611
MEGALUH,140,1296,592,319,2207,29,64,237,330,2537,-7.500557095,112.1908929
TEMBELANG,150,1586,675,334,2595,73,83,393,549,3144,-7.478748776,112.2499457
KESAMBEN,160,1952,1008,514,3474,119,116,470,705,4179,-7.469342985,112.3285803
KUDU,170,1188,635,295,2118,43,71,303,417,2535,-7.416092491,112.2956675
NGUSIKAN,171,1051,512,288,1851,63,73,266,402,2253,-7.389066931,112.3181201
PLOSO,180,1424,729,308,2461,45,77,339,461,2922,-7.439065768,112.2360636
KABUH,190,1804,824,364,2992,79,122,536,737,3729,-7.3878146,112.2088434
PLANDAAN,200,1274,671,269,2214,55,114,392,561,2775,-7.432098096,112.1352183
SAWAHAN,10,1872,717,139,2728,115,235,656,1006,3734,-7.747106849,111.7734813
NGETOS,20,1917,849,400,3166,238,260,526,1024,4190,-7.745867817,111.8286258
BERBEK,30,2295,1017,443,3755,201,253,686,1140,4895,-7.65182746,111.843833
LOCERET,40,3633,1721,587,5941,207,374,1137,1718,7659,-7.697824499,111.885064
PACE,50,2507,1178,500,4185,165,210,628,1003,5188,-7.684904895,111.9232029
TANJUNGANOM,60,3881,1694,707,6282,178,281,1040,1499,7781,-7.629775028,111.9989494
PRAMBON,70,2889,1211,521,4621,272,308,838,1418,6039,-7.703189749,112.0085662
NGRONGGOT,80,3770,1649,705,6124,177,271,966,1414,7538,-7.67521895,112.0551023
KERTOSONO,90,1940,904,416,3260,85,104,373,562,3822,-7.610384206,112.0890905
PATIANROWO,100,1564,729,328,2621,84,113,415,612,3233,-7.549035026,112.0990536
BARON,110,2017,845,314,3176,63,174,499,736,3912,-7.584735891,112.0512144
GONDANG,120,2506,1113,355,3974,117,210,765,1092,5066,-7.524454074,111.9939244
SUKOMORO,130,2488,1039,468,3995,111,140,583,834,4829,-7.59661092,111.9479766
NGANJUK,140,1977,959,528,3464,103,105,381,589,4053,-7.595309902,111.9058966
BAGOR,150,2101,1035,525,3661,118,108,427,653,4314,-7.58528778,111.8500063
WILANGAN,160,840,371,125,1336,25,53,238,316,1652,-7.602959406,111.8068502
REJOSO,170,2802,1109,482,4393,124,216,701,1041,5434,-7.497487432,111.8874995
NGLUYU,180,489,227,110,826,47,35,125,207,1033,-7.440786714,111.9863667
LENGKONG,190,1279,575,249,2103,55,80,308,443,2546,-7.481389042,112.0644016
JATIKALEN,200,851,409,143,1403,34,56,241,331,1734,-7.490487171,112.1260317
KEBONSARI,10,1229,705,435,2369,116,47,210,373,2742,-7.745103548,111.4848645
GEGER,20,1518,732,453,2703,28,53,281,362,3065,-7.707061924,111.5279235
DOLOPO,30,920,491,250,1661,41,45,202,288,1949,-7.777937979,111.5461326
DAGANGAN,40,1361,610,331,2302,54,84,320,458,2760,-7.730015504,111.5913331
WUNGU,50,1683,828,512,3023,80,82,377,539,3562,-7.655989329,111.5946818
KARE,60,1428,594,327,2349,70,135,442,647,2996,-7.724133041,111.6785189
GEMARANG,70,1767,668,238,2673,70,239,684,993,3666,-7.642851438,111.7399732
SARADAN,80,2555,1099,543,4197,116,237,676,1029,5226,-7.516826,111.7548707
PILANGKENCENG,90,1889,972,477,3338,60,105,467,632,3970,-7.474266915,111.662316
MEJAYAN,100,1575,826,483,2884,42,83,307,432,3316,-7.585432331,111.6793631
WONOASRI,110,1170,558,314,2042,42,50,233,325,2367,-7.594883756,111.6342791
BALEREJO,120,1357,670,468,2495,32,37,282,351,2846,-7.53845205,111.5952434
MADIUN,130,714,335,205,1254,25,21,145,191,1445,-7.591712907,111.5724211
SAWAHAN,140,503,289,185,977,10,26,91,127,1104,-7.56688787,111.5214875
JIWAN,150,1422,672,466,2560,38,45,230,313,2873,-7.612878114,111.488991
PONCOL,10,869,356,145,1370,68,96,390,554,1924,-7.720490036,111.249882
PARANG,20,1428,569,219,2216,40,106,598,744,2960,-7.749046119,111.3325864
LEMBEYAN,30,1159,554,305,2018,40,37,268,345,2363,-7.752174059,111.4057214
TAKERAN,40,728,334,212,1274,25,20,102,147,1421,-7.679012873,111.4779229
NGUNTORONADI,41,369,195,73,637,11,7,56,74,711,-7.710478997,111.4495817
KAWEDANAN,50,1326,661,353,2340,59,33,199,291,2631,-7.694239276,111.4076565
MAGETAN,60,598,278,151,1027,13,26,102,141,1168,-7.647068458,111.3335866
NGARIBOYO,61,949,402,216,1567,22,42,213,277,1844,-7.686799893,111.3369508
PLAOSAN,70,1393,551,174,2118,35,103,470,608,2726,-7.678241921,111.2367335
SIDOREJO,71,888,368,117,1373,13,70,320,403,1776,-7.650521764,111.2608039
PANEKAN,80,2037,807,396,3240,66,130,551,747,3987,-7.617062269,111.2807924
SUKOMORO,90,616,245,144,1005,10,11,97,118,1123,-7.62560149,111.376339
BENDO,100,964,416,238,1618,30,42,170,242,1860,-7.644748115,111.4328999
MAOSPATI,110,1032,502,260,1794,43,38,199,280,2074,-7.59826771,111.4437533
KARANGREJO,120,648,334,202,1184,24,29,152,205,1389,-7.558606578,111.4209113
KARAS,121,1022,449,251,1722,39,33,204,276,1998,-7.576909816,111.3768957
BARAT,130,675,306,208,1189,18,19,110,147,1336,-7.555186621,111.4608373
KARTOHARJO,131,467,218,130,815,26,20,118,164,979,-7.530493146,111.4766978
SINE,10,1914,863,390,3167,87,125,459,671,3838,-7.512842951,111.1698735
NGRAMBE,20,1545,778,457,2780,117,98,336,551,3331,-7.504466076,111.2170932
JOGOROGO,30,2094,957,380,3431,42,120,612,774,4205,-7.543327962,111.2508075
KENDAL,40,1861,825,411,3097,178,198,608,984,4081,-7.560824893,111.2976826
GENENG,50,1492,740,400,2632,132,104,393,629,3261,-7.479958043,111.4385692
GERIH,51,1244,679,365,2288,100,85,373,558,2846,-7.532939307,111.3834541
KWADUNGAN,60,832,343,173,1348,59,58,250,367,1715,-7.512995358,111.5109094
PANGKUR,70,1421,609,308,2338,49,103,387,539,2877,-7.497947159,111.5401408
KARANGJATI,80,2386,969,440,3795,93,162,652,907,4702,-7.452730477,111.6071396
BRINGIN,90,1702,657,219,2578,93,270,656,1019,3597,-7.402069527,111.5877614
PADAS,100,1481,537,239,2257,74,126,534,734,2991,-7.448415413,111.5287736
KASREMAN,101,1161,482,214,1857,54,191,368,613,2470,-7.396544078,111.5143869
NGAWI,110,2312,953,519,3784,127,151,524,802,4586,-7.414209319,111.4542545
PARON,120,3495,1513,822,5830,137,234,874,1245,7075,-7.463010914,111.3677899
KEDUNGGALAR,130,2734,1292,571,4597,120,178,621,919,5516,-7.424427744,111.3098521
PITU,140,1159,504,266,1929,168,120,273,561,2490,-7.361033088,111.3647746
WIDODAREN,150,2939,1408,769,5116,155,170,752,1077,6193,-7.409562615,111.2326568
MANTINGAN,160,1322,625,358,2305,42,67,294,403,2708,-7.385701928,111.1610182
KARANGANYAR,170,1561,620,279,2460,82,245,576,903,3363,-7.310550385,111.2204299
MARGOMULYO,10,1484,496,149,2129,100,206,444,750,2879,-7.318896014,111.4963505
NGRAHO,20,2947,1220,605,4772,232,232,652,1116,5888,-7.256051209,111.5404485
TAMBAKREJO,30,2844,1035,319,4198,161,364,871,1396,5594,-7.297781411,111.6298792
NGAMBON,40,604,287,125,1016,46,41,213,300,1316,-7.329123765,111.7164598
SEKAR,41,1494,513,162,2169,216,278,605,1099,3268,-7.400435426,111.7155838
BUBULAN,50,575,300,88,963,19,49,168,236,1199,-7.321980796,111.8295733
GONDANG,51,1187,596,340,2123,281,189,424,894,3017,-7.402095404,111.8283333
TEMAYANG,60,1079,457,205,1741,44,110,284,438,2179,-7.362485528,111.9147207
SUGIHWARAS,70,1698,664,207,2569,67,189,508,764,3333,-7.331996273,111.9682848
KEDUNGADEM,80,3245,1397,567,5209,170,343,928,1441,6650,-7.320037403,112.0362586
KEPOH BARU,90,2552,1231,654,4437,204,207,650,1061,5498,-7.19199751,112.094193
BAURENO,100,2713,1264,811,4788,206,188,511,905,5693,-7.122725731,112.0998111
KANOR,110,2023,938,426,3387,134,177,593,904,4291,-7.118776853,112.0291409
SUMBEREJO,120,2035,1069,714,3818,203,151,457,811,4629,-7.208791331,112.0279654
BALEN,130,2873,1278,624,4775,99,191,799,1089,5864,-7.195326454,111.9645213
SUKOSEWU,140,1179,511,263,1953,237,170,311,718,2671,-7.249215656,111.9309564
KAPAS,150,1936,791,376,3103,84,133,459,676,3779,-7.19413952,111.903338
BOJONEGORO,160,1080,413,212,1705,63,45,180,288,1993,-7.155693477,111.8941174
TRUCUK,170,1430,490,166,2086,51,151,457,659,2745,-7.123080765,111.8363697
DANDER,180,3097,1337,480,4914,174,291,957,1422,6336,-7.23301337,111.8432779
NGASEM,190,3159,1348,532,5039,285,336,915,1536,6575,-7.237436796,111.7506578
KALITIDU,200,2508,1051,388,3947,140,248,760,1148,5095,-7.147879774,111.7656759
MALO,210,1549,601,185,2335,92,199,548,839,3174,,
PURWOSARI,220,1486,556,276,2318,104,144,407,655,2973,-7.221110261,111.6697181
PADANGAN,230,1297,494,181,1972,77,90,365,532,2504,-7.183394879,111.613514
KASIMAN,240,971,386,108,1465,64,93,316,473,1938,-7.115493275,111.6406089
KEDEWAN,241,325,107,24,456,21,34,88,143,599,-7.045402781,111.6475542
KENDURUAN,10,1247,490,162,1899,101,188,436,725,2624,-6.937916464,111.6288209
BANGILAN,20,1890,752,318,2960,147,244,647,1038,3998,-6.960355774,111.710556
SENORI,30,2100,948,437,3485,139,295,735,1169,4654,-7.039600972,111.7269956
SINGGAHAN,40,1683,769,302,2754,89,147,517,753,3507,-6.980124635,111.7786195
MONTONG,50,1582,550,198,2330,163,358,659,1180,3510,-6.974744309,111.88307
PARENGAN,60,1708,601,257,2566,85,236,590,911,3477,-7.062058111,111.8530452
SOKO,70,3717,1579,714,6010,224,398,1375,1997,8007,-7.095328385,111.9369468
RENGEL,80,2131,989,568,3688,154,196,586,936,4624,-7.070204447,112.0093212
GRABAGAN,81,1593,638,215,2446,72,312,748,1132,3578,-7.007628099,111.9936048
PLUMPANG,90,3669,1499,604,5772,184,479,1273,1936,7708,-7.042079599,112.1086316
WIDANG,100,1756,778,381,2915,153,183,510,846,3761,-7.032850005,112.1747983
PALANG,110,3075,1226,491,4792,143,362,980,1485,6277,-6.935667699,112.150638
SEMANDING,120,2626,1021,358,4005,247,621,1036,1904,5909,-6.954309722,112.0547757
TUBAN,130,1855,881,526,3262,59,148,526,733,3995,-6.89509044,112.0336113
JENU,140,1970,949,400,3319,138,229,546,913,4232,-6.814045881,111.9594418
MERAKURAK,150,1833,794,319,2946,95,283,747,1125,4071,-6.880828112,111.9587316
KEREK,160,1564,551,149,2264,513,513,725,1751,4015,-6.888481372,111.8542929
TAMBAKBOYO,170,1383,493,182,2058,118,233,486,837,2895,-6.844729709,111.8089744
JATIROGO,180,1379,557,225,2161,110,191,457,758,2919,-6.87061167,111.6761575
BANCAR,190,2182,834,352,3368,174,365,751,1290,4658,-6.808404676,111.7362193
SUKORAME,10,931,403,208,1542,73,85,285,443,1985,-7.35103153,112.1082455
BLULUK,20,814,381,264,1459,84,65,197,346,1805,-7.299797269,112.1265254
NGIMBANG,30,2117,859,454,3430,110,174,617,901,4331,-7.297751851,112.192029
SAMBENG,40,1845,970,587,3402,84,185,714,983,4385,-7.298059945,112.2792912
MANTUP,50,1619,796,465,2880,84,127,473,684,3564,-7.268122945,112.3528509
KEMBANGBAHU,60,1747,940,470,3157,93,122,597,812,3969,-7.203736996,112.3610965
SUGIO,70,2249,1111,818,4178,243,196,646,1085,5263,-7.181078448,112.2745461
KEDUNGPRING,80,2938,1405,830,5173,50,123,805,978,6151,-7.185778797,112.2037129
MODO,90,1907,956,545,3408,105,131,574,810,4218,-7.218908973,112.1380386
BABAT,100,4146,2032,1116,7294,171,274,1221,1666,8960,-7.108988502,112.2143524
PUCUK,110,2208,1117,622,3947,64,136,607,807,4754,-7.092794773,112.2927924
SUKODADI,120,2087,1058,772,3917,207,150,565,922,4839,-7.114658547,112.3369423
LAMONGAN,130,1517,738,534,2789,71,83,324,478,3267,-7.125641539,112.3930266
TIKUNG,140,1387,740,397,2524,69,137,428,634,3158,-7.188664107,112.412201
SARIREJO,141,856,429,295,1580,82,34,210,326,1906,-7.176453263,112.4604389
DEKET,150,1346,734,546,2626,94,63,215,372,2998,-7.09943793,112.4549135
GLAGAH,160,1571,898,705,3174,78,56,288,422,3596,-7.073785611,112.5043689
KARANGBINANGUN,170,1731,883,594,3208,43,78,465,586,3794,-7.032428637,112.4606762
TURI,180,1981,983,720,3684,281,173,511,965,4649,-7.071168701,112.3862785
KALITENGAH,190,1165,562,405,2132,62,53,251,366,2498,-7.019850047,112.3940404
KARANG GENENG,200,1361,733,458,2552,72,90,333,495,3047,-7.012238524,112.3415058
SEKARAN,210,1726,960,555,3241,56,114,405,575,3816,-7.052114932,112.2668234
MADURAN,220,1148,621,371,2140,21,68,307,396,2536,-7.009863824,112.2763827
LAREN,230,1597,778,494,2869,117,85,375,577,3446,-6.974274847,112.2710067
SOLOKURO,240,1186,635,368,2189,69,57,289,415,2604,-6.928093658,112.358124
PACIRAN,250,2014,970,605,3589,81,115,407,603,4192,-6.886173071,112.3685871
BRONDONG,260,1621,712,348,2681,61,126,468,655,3336,-6.906535914,112.23779
WRINGINANOM,10,2574,1231,548,4353,78,162,748,988,5341,-7.374205252,112.518343
DRIYOREJO,20,3260,1655,855,5770,103,93,621,817,6587,-7.344985131,112.6080358
KEDAMEAN,30,2108,1038,434,3580,80,167,692,939,4519,-7.316754363,112.5277258
MENGANTI,40,2768,1263,536,4567,158,233,801,1192,5759,-7.277751123,112.5826559
CERME,50,2281,1080,639,4000,155,115,604,874,4874,-7.217232044,112.5557998
BENJENG,60,2407,1134,526,4067,103,201,786,1090,5157,-7.242595407,112.489902
BALONGPANGGANG,70,1440,778,399,2617,158,123,417,698,3315,-7.269213832,112.4365738
DUDUKSAMPEYAN,80,2049,1044,660,3753,92,67,386,545,4298,-7.146704427,112.5267152
KEBOMAS,90,1255,584,402,2241,86,43,189,318,2559,-7.178016072,112.618784
GRESIK,100,828,460,286,1574,19,38,156,213,1787,-7.164923891,112.6482944
MANYAR,110,2659,1369,833,4861,75,65,479,619,5480,-7.098082808,112.5916997
BUNGAH,120,2493,1257,711,4461,105,73,615,793,5254,-7.025500661,112.5895228
SIDAYU,130,2110,942,534,3586,32,98,468,598,4184,-6.980018576,112.5600433
DUKUN,140,2394,1235,800,4429,112,104,581,797,5226,-6.984069071,112.4475558
PANCENG,150,1866,887,528,3281,90,82,419,591,3872,-6.931915939,112.463583
UJUNGPANGKAH,160,2207,1062,635,3904,123,121,503,747,4651,-6.925757875,112.5458751
SANGKAPURA,170,2961,980,479,4420,86,232,627,945,5365,-5.80928461,112.6618314
TAMBAK,180,1616,539,249,2404,62,122,277,461,2865,-5.754944006,112.6557101
KAMAL,10,1069,336,184,1589,89,166,313,568,2157,-7.136510712,112.7275969
LABANG,20,1192,457,243,1892,69,209,370,648,2540,-7.136146644,112.7880936
KWANYAR,30,2065,792,421,3278,209,316,579,1104,4382,-7.146939652,112.8772381
MODUNG,40,3460,1559,942,5961,436,421,919,1776,7737,-7.171568607,112.9765012
BLEGA,50,2798,1198,945,4941,617,668,825,2110,7051,-7.124263382,113.048907
KONANG,60,4253,1418,834,6505,507,983,1562,3052,9557,-7.044959749,113.0567245
GALIS,70,3881,1329,765,5975,615,862,1405,2882,8857,-7.088462968,112.9631786
TANAH MERAH,80,3768,1218,427,5413,507,905,1338,2750,8163,-7.071814728,112.869693
TRAGAH,90,1491,570,261,2322,170,337,626,1133,3455,-7.100248582,112.8219377
SOCAH,100,1157,482,225,1864,78,134,323,535,2399,-7.081087839,112.7316556
BANGKALAN,110,1107,450,301,1858,93,106,191,390,2248,-7.028988196,112.7399529
BURNEH,120,1333,675,406,2414,66,91,228,385,2799,-7.033123461,112.803411
AROSBAYA,130,1469,544,279,2292,152,278,404,834,3126,-6.972610709,112.8392704
GEGER,140,4279,1584,1032,6895,805,925,1562,3292,10187,-7.002307606,112.9324699
KOKOP,150,6380,2510,1527,10417,2049,1439,2439,5927,16344,-6.980971919,113.0636873
TANJUNGBUMI,160,2451,761,380,3592,280,598,868,1746,5338,-6.910449274,113.0638946
SEPULU,170,1856,756,644,3256,312,325,517,1154,4410,-6.927098477,112.9685672
KLAMPIS,180,1587,725,506,2818,165,169,336,670,3488,-6.925788448,112.8893617
SRESEH,10,2214,1023,485,3722,63,211,505,779,4501,-7.193453516,113.0956207
TORJUN,20,3448,1425,610,5483,175,495,975,1645,7128,-7.14664849,113.2049553
PANGARENGAN,21,1665,571,211,2447,73,234,473,780,3227,-7.192924652,113.172196
SAMPANG,30,6097,2218,1006,9321,567,964,1722,3253,12574,-7.178700767,113.2520827
CAMPLONG,40,6485,2237,982,9704,303,1058,2135,3496,13200,-7.18842142,113.3370921
OMBEN,50,7375,2110,921,10406,567,1948,2860,5375,15781,-7.107039038,113.3283064
KEDUNGDUNG,60,9457,3018,989,13464,725,2313,3987,7025,20489,-7.067470156,113.2420351
JRENGIK,70,3234,1165,465,4864,218,653,1105,1976,6840,-7.128088651,113.1430776
TAMBELANGAN,80,4339,1617,712,6668,466,987,1465,2918,9586,-7.044014355,113.1573915
BANYUATES,90,5432,2165,1359,8956,395,680,1346,2421,11377,-6.948221355,113.1760092
ROBATAL,100,4792,1812,942,7546,441,820,1593,2854,10400,-7.003267904,113.2881035
KARANG PENANG,101,6395,3227,2175,11797,338,529,1725,2592,14389,-7.0178543,113.3733792
KETAPANG,110,4846,1552,689,7087,270,728,1350,2348,9435,-6.925157662,113.3032562
SOKOBANAH,120,2780,1056,614,4450,193,328,672,1193,5643,-6.935707218,113.4097163
TLANAKAN,10,3998,1669,905,6572,401,574,1167,2142,8714,-7.196810532,113.4321884
PADEMAWU,20,2675,1090,611,4376,126,179,527,832,5208,-7.196647207,113.5155147
GALIS,30,1069,520,334,1923,86,48,152,286,2209,-7.160411146,113.5540709
LARANGAN,40,1899,908,540,3347,72,97,365,534,3881,-7.119716848,113.55038
PAMEKASAN,50,2299,1061,524,3884,91,116,335,542,4426,-7.15769353,113.4737213
PROPPO,60,7108,3009,1439,11556,786,1327,2645,4758,16314,-7.134386522,113.4089577
PALENGAAN,70,4980,2616,1613,9209,390,487,1187,2064,11273,-7.075389171,113.4336093
PEGANTENAN,80,4751,2471,1404,8626,304,452,1037,1793,10419,-7.039554908,113.4770283
KADUR,90,2380,1324,805,4509,388,158,484,1030,5539,-7.085224706,113.5612977
PAKONG,100,2098,994,636,3728,79,73,330,482,4210,-7.042154646,113.559319
WARU,110,4588,2350,1473,8411,335,315,790,1440,9851,-6.979560732,113.5637766
BATU MARMAR,120,5979,2571,1499,10049,604,534,1001,2139,12188,-6.95701139,113.4952012
PASEAN,130,2862,1311,718,4891,217,223,559,999,5890,-6.923097412,113.5937515
PRAGAAN,10,2716,1376,975,5067,459,242,688,1389,6456,-7.09649749,113.6571181
BLUTO,20,1974,989,684,3647,163,106,335,604,4251,-7.103711186,113.7753036
SARONGGI,30,1875,833,401,3109,185,112,397,694,3803,-7.088106792,113.8391838
GILIGENTENG,40,1304,587,297,2188,205,182,430,817,3005,-7.206598301,113.8617131
TALANGO,50,887,466,308,1661,174,121,232,527,2188,-7.088033477,114.0020073
KALIANGET,60,653,276,116,1045,85,65,105,255,1300,-7.04801957,113.896639
KOTA SUMENEP,70,845,308,187,1340,45,33,111,189,1529,-7.00930151,113.8732888
BATUAN,71,273,100,53,426,23,15,38,76,502,-7.022449923,113.8369975
LENTENG,80,2510,1172,785,4467,205,145,389,739,5206,-7.037573347,113.7674125
GANDING,90,1633,803,533,2969,187,101,346,634,3603,-7.035375768,113.7038598
GULUK GULUK,100,2256,1156,782,4194,201,105,426,732,4926,-7.043128912,113.6366619
PASONGSONGAN,110,1692,730,337,2759,101,198,468,767,3526,-6.953105005,113.6617074
AMBUNTEN,120,1307,464,241,2012,136,190,307,633,2645,-6.908951646,113.7430858
RUBARU,130,1824,649,341,2814,139,227,462,828,3642,-6.969951834,113.7623993
DASUK,140,1185,424,240,1849,164,281,484,929,2778,-6.912954208,113.8232668
MANDING,150,817,256,119,1192,121,157,221,499,1691,-6.95990466,113.8801496
BATUPUTIH,160,1127,459,235,1821,142,180,288,610,2431,-6.904197605,113.9307288
GAPURA,170,1011,525,396,1932,130,64,161,355,2287,-7.000937001,113.9566501
BATANG BATANG,180,2298,1045,531,3874,171,211,645,1027,4901,-6.942957042,114.0112344
DUNGKEK,190,824,357,213,1394,74,75,165,314,1708,-6.971778964,114.0854383
NONGGUNONG,200,563,153,53,769,65,116,151,332,1101,-7.060641735,114.3422076
GAYAM,210,1286,600,261,2147,117,183,291,591,2738,-7.136393255,114.3392979
RAAS,220,1862,825,411,3098,239,174,415,828,3926,-7.144464425,114.5922985
SAPEKEN,230,1955,714,473,3142,391,232,375,998,4140,-7.082190429,115.7547502
ARJASA,240,2362,961,476,3799,161,247,511,919,4718,-6.915607729,115.2968585
KANGAYAN,241,1198,432,253,1883,82,130,235,447,2330,-6.899947054,115.4514944
MASALEMBU,250,486,168,79,733,25,41,80,146,879,-5.422628219,114.4671433
MOJOROTO,10,2339,948,607,3894,59,94,437,590,4484,-7.808026766,111.9872968
KOTA KEDIRI,20,1843,764,471,3078,33,73,340,446,3524,-7.83045517,112.0176912
PESANTREN,30,2202,991,548,3741,46,78,406,530,4271,-7.847113737,112.0454722
SUKOREJO,10,1183,513,240,1936,28,57,211,296,2232,-8.098686304,112.1483896
KEPANJENKIDUL,20,665,343,192,1200,18,25,107,150,1350,-8.079300429,112.1746745
SANANWETAN,30,796,364,223,1383,23,20,140,183,1566,-8.105007467,112.1755914
KEDUNGKANDANG,10,2760,1003,396,4159,226,407,806,1439,5598,-8.007896489,112.6577261
SUKUN,20,2655,1172,552,4379,139,201,642,982,5361,-7.993105848,112.6109851
KLOJEN,30,1307,604,319,2230,42,64,255,361,2591,-7.974488705,112.6260069
BLIMBING,40,2265,1113,655,4033,91,135,458,684,4717,-7.951249061,112.649264
LOWOKWARU,50,1676,746,425,2847,64,128,316,508,3355,-7.938859457,112.6157817
KADEMANGAN,10,1634,754,416,2804,73,120,378,571,3375,-7.768543501,113.1819369
KEDOPOK,11,1102,490,240,1832,129,195,320,644,2476,-7.790218829,113.2021881
WONOASIH,20,1616,661,294,2571,90,160,412,662,3233,-7.796917639,113.2219255
MAYANGAN,30,1785,764,382,2931,71,132,348,551,3482,-7.746710454,113.219604
KANIGARAN,31,2146,999,606,3751,110,135,417,662,4413,-7.764051618,113.2115943
GADINGREJO,10,2173,1011,553,3737,154,241,629,1024,4761,-7.640082082,112.8886787
PURWOREJO,20,1867,888,536,3291,57,95,378,530,3821,-7.658267441,112.8983659
BUGULKIDUL,30,1610,687,438,2735,59,111,352,522,3257,-7.651387696,112.9246239
PRAJURIT KULON,10,1358,669,425,2452,33,62,275,370,2822,-7.475725133,112.422949
MAGERSARI,20,1449,646,379,2474,23,51,298,372,2846,-7.467416201,112.4502299
MANGU HARJO,10,835,453,312,1600,19,16,135,170,1770,-7.618943582,111.5158206
TAMAN,20,1063,527,327,1917,12,18,181,211,2128,-7.647222004,111.5273226
KARTOHARJO,30,869,402,291,1562,20,11,131,162,1724,-7.617128468,111.5422344
KARANG PILANG,10,352,197,100,649,8,15,88,111,760,-7.335170551,112.6884469
JAMBANGAN,20,664,306,202,1172,32,23,105,160,1332,-7.323126679,112.7156978
GAYUNGAN,30,284,148,88,520,13,9,36,58,578,-7.329994199,112.7268749
WONOCOLO,40,466,196,151,813,23,15,72,110,923,-7.322317796,112.741663
TENGGILIS MEJOYO,50,359,179,112,650,9,11,79,99,749,-7.324462072,112.7540396
GUNUNG ANYAR,60,505,237,133,875,11,11,102,124,999,-7.337692211,112.794868
RUNGKUT,70,988,458,392,1838,79,47,148,274,2112,-7.318941278,112.8019511
SUKOLILO,80,1202,572,365,2139,35,58,232,325,2464,-7.292634656,112.805578
MULYOREJO,90,591,273,179,1043,17,23,110,150,1193,-7.267551003,112.7968496
GUBENG,100,1091,504,345,1940,77,39,149,265,2205,-7.279649662,112.7593971
WONOKROMO,110,1696,748,485,2929,65,67,285,417,3346,-7.297710358,112.7379058
DUKUH PAKIS,120,345,174,115,634,35,23,51,109,743,-7.291912987,112.6999151
WIYUNG,130,420,221,134,775,27,34,100,161,936,-7.312620619,112.6883212
LAKARSANTRI,140,721,360,198,1279,26,43,138,207,1486,-7.313129672,112.6557301
SAMBIKEREP,141,449,228,108,785,10,26,97,133,918,-7.276548361,112.6531676
TANDES,150,1090,472,284,1846,29,35,172,236,2082,-7.255682433,112.6715037
SUKO MANUNGGAL,160,945,496,345,1786,83,40,193,316,2102,-7.268807142,112.6997379
SAWAHAN,170,2303,890,590,3783,121,84,365,570,4353,-7.273057318,112.7214541
TEGALSARI,180,1428,660,405,2493,61,46,253,360,2853,-7.275507707,112.7367923
GENTENG,190,737,327,191,1255,37,28,128,193,1448,-7.259098748,112.7449471
TAMBAKSARI,200,3200,1460,821,5481,174,183,613,970,6451,-7.250693171,112.7680596
KENJERAN,210,2405,977,557,3939,243,328,756,1327,5266,-7.217636225,112.7688646
BULAK,211,318,149,143,610,32,27,63,122,732,-7.238995781,112.7901282
SIMOKERTO,220,3362,1321,737,5420,194,291,870,1355,6775,-7.239473549,112.7532921
SEMAMPIR,230,6814,2826,1440,11080,272,491,1643,2406,13486,-7.213851019,112.7484093
PABEAN CANTIAN,240,1719,746,435,2900,116,118,399,633,3533,-7.219385074,112.7335942
BUBUTAN,250,1682,753,440,2875,103,104,320,527,3402,-7.248799976,112.7278235
KREMBANGAN,260,1832,799,448,3079,90,169,431,690,3769,-7.229116232,112.7217528
ASEMROWO,270,667,255,115,1037,18,60,228,306,1343,-7.237432641,112.6897654
BENOWO,280,422,217,108,747,14,28,87,129,876,-7.226496904,112.6463486
PAKAL,281,361,184,107,652,53,41,87,181,833,-7.229671827,112.6160294
BATU,10,1834,797,405,3036,63,94,379,536,3572,-7.887289313,112.5090877
JUNREJO,20,641,259,148,1048,75,65,161,301,1349,-7.906877379,112.5473625
BUMIAJI,30,1450,551,177,2178,64,181,444,689,2867,-7.796277761,112.5359312
SUMUR,10,2285,705,226,3216,100,309,612,1021,4237,-6.733648645,105.3945192
CIMANGGU,20,2015,654,253,2922,143,317,584,1044,3966,-6.751030738,105.6402407
CIBALIUNG,30,3508,758,263,4529,145,605,950,1700,6229,-6.723589982,105.755414
CIBITUNG,31,2435,540,169,3144,146,386,600,1132,4276,-6.796277331,105.7199785
CIKEUSIK,40,4860,1146,289,6295,177,776,1321,2274,8569,-6.769991643,105.829916
CIGEULIS,50,3370,651,215,4236,264,908,1230,2402,6638,-6.618135044,105.6846462
PANIMBANG,60,2461,646,204,3311,361,560,833,1754,5065,-6.526545216,105.7140349
SOBANG,61,1822,547,256,2625,127,217,490,834,3459,-6.605773218,105.7804154
MUNJUL,70,1731,562,182,2475,66,233,464,763,3238,-6.630239604,105.9083291
ANGSANA,71,1947,530,178,2655,188,373,613,1174,3829,-6.602686733,105.8498133
SINDANGRESMI,72,1754,520,122,2396,79,222,503,804,3200,-6.543647651,105.9189546
PICUNG,80,3205,959,259,4423,158,492,1044,1694,6117,-6.500210324,105.9489837
BOJONG,90,2350,598,139,3087,218,613,829,1660,4747,-6.452773284,105.9899092
SAKETI,100,3526,1049,393,4968,240,500,1117,1857,6825,-6.410741478,105.9670045
CISATA,101,1860,641,263,2764,64,186,506,756,3520,-6.408387266,105.9307223
PAGELARAN,110,2461,697,310,3468,234,501,880,1615,5083,-6.419113726,105.8561128
PATIA,111,1885,608,249,2742,234,372,584,1190,3932,-6.479551264,105.8775526
SUKARESMI,112,2657,721,266,3644,187,436,787,1410,5054,-6.501043709,105.8382664
LABUAN,120,3256,974,349,4579,149,446,1000,1595,6174,-6.370590099,105.8362531
CARITA,121,2046,692,285,3023,122,263,643,1028,4051,-6.279447842,105.8617958
JIPUT,130,2730,1013,380,4123,115,295,807,1217,5340,-6.320016615,105.8900439
CIKEDAL,131,2416,859,281,3556,46,224,659,929,4485,-6.385796292,105.8853109
MENES,140,2616,998,425,4039,88,194,673,955,4994,-6.38081107,105.9238364
PULOSARI,141,2980,1078,406,4464,81,276,694,1051,5515,-6.333156643,105.9391839
MANDALAWANGI,150,3931,1118,299,5348,285,704,1293,2282,7630,-6.291994204,105.9782499
CIMANUK,160,2306,717,230,3253,109,305,532,946,4199,-6.353749617,106.0413024
CIPEUCANG,161,1846,542,201,2589,161,353,603,1117,3706,-6.374965131,106.0136199
BANJAR,170,2189,685,240,3114,114,376,801,1291,4405,-6.376410411,106.1036523
KADUHEJO,171,2817,888,220,3925,124,432,963,1519,5444,-6.316998779,106.0560155
MEKARJAYA,172,1795,599,144,2538,173,276,369,818,3356,-6.398541173,106.0671628
PANDEGLANG,180,1320,336,144,1800,129,220,406,755,2555,-6.323879758,106.1159835
MAJASARI,181,2395,649,214,3258,187,419,676,1282,4540,-6.311598721,106.0844758
CADASARI,190,2460,857,347,3664,125,326,706,1157,4821,-6.259381407,106.1057751
KARANGTANJUNG,191,1894,541,229,2664,110,283,561,954,3618,-6.287838804,106.1137061
KORONCONG,192,1670,545,325,2540,132,224,423,779,3319,-6.290083131,106.1513271
MALINGPING,10,5140,1434,494,7068,463,1146,1765,3374,10442,-6.768426293,106.0046333
WANASALAM,11,4970,1558,640,7168,672,1156,1649,3477,10645,-6.765215119,105.9214822
PANGGARANGAN,20,2261,830,256,3347,155,327,701,1183,4530,-6.829178202,106.2242598
CIHARA,21,1962,586,227,2775,197,452,668,1317,4092,-6.837194636,106.1193626
BAYAH,30,1547,540,171,2258,74,238,452,764,3022,-6.919990544,106.2937487
CILOGRANG,31,1679,624,166,2469,94,217,448,759,3228,-6.916163186,106.3733467
CIBEBER,40,2470,766,268,3504,259,477,845,1581,5085,-6.773790488,106.3642677
CIJAKU,50,2191,707,249,3147,191,471,736,1398,4545,-6.719048048,106.0664382
CIGEMBLONG,51,1403,573,401,2377,228,232,409,869,3246,-6.740601217,106.1710112
BANJARSARI,60,4148,1264,400,5812,542,1192,1751,3485,9297,-6.598470994,105.985301
CILELES,70,3254,1220,538,5012,209,508,950,1667,6679,-6.488541759,106.0778272
GUNUNG KENCANA,80,2821,773,258,3852,238,563,895,1696,5548,-6.6070144,106.0502841
BOJONGMANIK,90,1402,414,133,1949,179,369,442,990,2939,-6.583906426,106.1693581
CIRINTEN,91,1630,522,191,2343,283,546,653,1482,3825,-6.647047548,106.1406486
LEUWIDAMAR,100,3325,884,358,4567,1358,1124,1444,3926,8493,-6.574126476,106.2215726
MUNCANG,110,3465,1264,715,5444,516,646,965,2127,7571,-6.552755146,106.2870337
SOBANG,111,2155,740,231,3126,225,427,679,1331,4457,-6.648327097,106.3221153
CIPANAS,120,2482,802,262,3546,211,567,853,1631,5177,-6.553116363,106.3665902
LEBAKGEDONG,121,1396,304,63,1763,126,378,515,1019,2782,-6.63086241,106.4062967
SAJIRA,130,4107,1525,570,6202,439,730,1487,2656,8858,-6.475052884,106.3369299
CIMARGA,140,5181,1621,708,7510,774,1229,1790,3793,11303,-6.453239999,106.2219892
CIKULUR,150,4505,1606,535,6646,251,639,1468,2358,9004,-6.392903869,106.1479288
WARUNGGUNUNG,160,3850,1343,401,5594,314,618,1235,2167,7761,-6.32569406,106.1770891
CIBADAK,170,3376,1281,617,5274,644,646,1203,2493,7767,-6.333105154,106.2251081
RANGKASBITUNG,180,4667,1535,545,6747,448,955,1689,3092,9839,-6.356803234,106.2835455
KALANGANYAR,181,2437,763,247,3447,172,486,854,1512,4959,-6.385344448,106.233209
MAJA,190,3615,985,268,4868,536,1140,1570,3246,8114,-6.368120058,106.3650545
CURUGBITUNG,191,2432,906,370,3708,300,564,969,1833,5541,-6.435578198,106.3974207
CISOKA,10,3869,1461,614,5944,236,706,1731,2673,8617,-6.25975498,106.4166909
SOLEAR,11,4141,1561,682,6384,214,688,1782,2684,9068,-6.307318599,106.4216948
TIGARAKSA,20,3815,1665,822,6302,184,522,1457,2163,8465,-6.265799784,106.4672718
JAMBE,21,2187,963,441,3591,93,263,758,1114,4705,-6.324546024,106.4989284
CIKUPA,30,1080,531,222,1833,93,215,592,900,2733,-6.217902191,106.5162132
PANONGAN,40,2041,832,310,3183,134,385,1008,1527,4710,-6.27874043,106.5261997
CURUG,50,1380,569,223,2172,70,189,596,855,3027,-6.24240128,106.5661556
KELAPA DUA,51,529,236,127,892,47,106,262,415,1307,-6.242163736,106.6098514
LEGOK,60,2790,993,437,4220,320,550,1382,2252,6472,-6.304274953,106.5653349
PAGEDANGAN,70,2013,729,340,3082,134,418,975,1527,4609,-6.297461985,106.6174685
CISAUK,81,2034,692,290,3016,250,411,943,1604,4620,-6.339028658,106.6301071
PASARKEMIS,120,2277,906,425,3608,269,463,1061,1793,5401,-6.158696595,106.5526156
SINDANG JAYA,121,2760,1026,491,4277,247,629,1458,2334,6611,-6.169561503,106.4993005
BALARAJA,130,2103,1026,550,3679,109,285,843,1237,4916,-6.205403822,106.4408853
JAYANTI,131,2001,865,468,3334,160,303,804,1267,4601,-6.205878832,106.397186
SUKAMULYA,132,2477,1081,551,4109,147,347,1083,1577,5686,-6.160007645,106.436748
KRESEK,140,2790,1183,630,4603,124,395,1154,1673,6276,-6.144135767,106.4037441
GUNUNG KALER,141,2901,1190,529,4620,240,444,1282,1966,6586,-6.095780605,106.374074
KRONJO,150,2708,1070,396,4174,153,341,1096,1590,5764,-6.070622301,106.4285407
MEKAR BARU,151,2697,1223,464,4384,212,309,1077,1598,5982,-6.061924691,106.3877376
MAUK,160,4002,1590,709,6301,308,695,1803,2806,9107,-6.056303449,106.5192433
KEMIRI,161,3288,1332,656,5276,272,518,1429,2219,7495,-6.087464158,106.4638577
SUKADIRI,162,1949,898,422,3269,98,259,840,1197,4466,-6.070104034,106.5580661
RAJEG,170,5925,2526,968,9419,376,1090,2970,4436,13855,-6.116067472,106.5102675
SEPATAN,180,2263,980,517,3760,209,385,1091,1685,5445,-6.118942307,106.5799517
SEPATAN TIMUR,181,3932,1546,435,5913,187,765,2184,3136,9049,-6.119688142,106.6082389
PAKUHAJI,190,6347,2597,1380,10324,521,1103,2636,4260,14584,-6.058405097,106.6063142
TELUKNAGA,200,5619,2195,874,8688,446,1262,2918,4626,13314,-6.051626995,106.6596501
KOSAMBI,210,3397,1378,626,5401,300,714,1605,2619,8020,-6.0768869,106.6882081
CINANGKA,10,2414,671,223,3308,113,346,651,1110,4418,-6.180006747,105.8864783
PADARINCANG,20,3719,862,266,4847,192,576,982,1750,6597,-6.207636357,105.9684475
CIOMAS,30,2885,614,161,3660,118,534,847,1499,5159,-6.244481356,106.0296247
PABUARAN,40,2033,709,247,2989,99,278,521,898,3887,-6.196282349,106.0906248
GUNUNG SARI,41,1103,363,101,1567,84,170,285,539,2106,-6.153587945,106.0365737
BAROS,50,3389,994,299,4682,119,427,886,1432,6114,-6.226310391,106.1210471
PETIR,60,2208,644,227,3079,111,259,610,980,4059,-6.242295711,106.1986056
TUNJUNG TEJA,61,2672,834,317,3823,114,346,727,1187,5010,-6.280915932,106.23233
CIKEUSAL,80,3091,812,221,4124,148,531,961,1640,5764,-6.214036432,106.2535883
PAMARAYAN,90,3090,913,263,4266,254,501,853,1608,5874,-6.27783243,106.3017777
BANDUNG,91,1928,567,203,2698,145,314,724,1183,3881,-6.221151998,106.3088649
JAWILAN,100,2695,979,334,4008,157,425,880,1462,5470,-6.288679124,106.3435326
KOPO,110,2673,857,280,3810,145,439,795,1379,5189,-6.28513757,106.3766337
CIKANDE,120,3079,1283,511,4873,112,266,952,1330,6203,-6.191257371,106.3540819
KIBIN,121,1011,371,133,1515,25,152,379,556,2071,-6.161810532,106.3157408
KRAGILAN,130,1788,635,178,2601,72,201,497,770,3371,-6.143149421,106.2751715
WARINGINKURUNG,180,1374,503,231,2108,65,207,474,746,2854,-6.090960536,106.0703317
MANCAK,190,2263,773,284,3320,182,281,574,1037,4357,-6.102527563,105.9869275
ANYAR,200,1388,460,202,2050,49,122,291,462,2512,-6.089798574,105.9218292
BOJONEGARA,210,1213,298,66,1577,65,347,531,943,2520,-5.960796948,106.0737638
PULO AMPEL,211,642,218,111,971,20,70,168,258,1229,-5.918023287,106.0866335
KRAMATWATU,220,1996,589,187,2772,115,381,660,1156,3928,-6.039889644,106.1130245
CIRUAS,240,2259,701,254,3214,156,412,761,1329,4543,-6.098227591,106.2450487
PONTANG,250,1848,731,300,2879,78,250,543,871,3750,-6.031264906,106.2642306
CARENANG,260,1887,773,285,2945,97,198,565,860,3805,-6.085545749,106.3191372
BINUANG,261,1203,460,173,1836,56,148,449,653,2489,-6.132540432,106.349053
TIRTAYASA,270,1592,591,207,2390,50,223,507,780,3170,-5.986139701,106.3108765
TANARA,271,2268,967,445,3680,83,178,549,810,4490,-6.01955161,106.3647898
CILEDUG,10,2453,1045,457,3955,87,108,448,643,4598,-6.238776131,106.70568
LARANGAN,11,1798,767,429,2994,57,85,279,421,3415,-6.238567046,106.7326885
KARANG TENGAH,12,1802,874,476,3152,76,83,345,504,3656,-6.210029889,106.7095318
CIPONDOH,20,2145,1011,621,3777,179,182,580,941,4718,-6.186329293,106.6818438
PINANG,21,2947,1326,706,4979,124,178,738,1040,6019,-6.215747026,106.6663271
TANGERANG,30,2670,1038,545,4253,143,233,651,1027,5280,-6.189195115,106.6407461
KARAWACI,31,3424,1434,762,5620,173,316,895,1384,7004,-6.18128634,106.6179764
JATI UWUNG,40,1604,673,365,2642,169,167,457,793,3435,-6.198013943,106.575282
CIBODAS,41,2245,911,402,3558,131,193,531,855,4413,-6.205725436,106.6079141
PERIUK,42,2855,1139,614,4608,95,221,701,1017,5625,-6.167456353,106.5942805
BATUCEPER,50,1692,759,362,2813,77,130,430,637,3450,-6.161995453,106.6705277
NEGLASARI,51,4781,1895,901,7577,303,685,1717,2705,10282,-6.142245674,106.6305408
BENDA,60,2539,1226,659,4424,279,278,779,1336,5760,-6.128538189,106.6659309
CIWANDAN,10,1669,899,635,3203,30,54,339,423,3626,-6.031811016,105.9666086
CITANGKIL,11,1099,618,325,2042,27,89,321,437,2479,-6.014775108,106.0116986
PULOMERAK,20,818,422,225,1465,32,78,285,395,1860,-5.921088827,106.0209122
PURWAKARTA,21,571,330,199,1100,14,38,180,232,1332,-5.982858813,106.0462179
GROGOL,22,456,259,199,914,16,35,133,184,1098,-5.970466535,106.0197261
CILEGON,30,634,306,192,1132,18,72,213,303,1435,-6.043709306,106.0392555
JOMBANG,31,980,412,204,1596,36,89,347,472,2068,-6.009501128,106.065278
CIBEBER,40,1095,600,379,2074,110,131,383,624,2698,-6.048152778,106.0555207
CURUG,10,1772,635,233,2640,208,455,808,1471,4111,-6.187392476,106.173828
WALANTAKA,20,1995,825,299,3119,145,402,829,1376,4495,-6.149574409,106.2224979
CIPOCOK JAYA,30,1694,648,251,2593,154,421,838,1413,4006,-6.144771158,106.1691819
SERANG,40,2185,816,477,3478,385,587,903,1875,5353,-6.111656619,106.1640092
TAKTAKAN,50,1563,548,197,2308,102,361,635,1098,3406,-6.131141541,106.1076134
KASEMEN,60,4838,1184,337,6359,732,1517,2051,4300,10659,-6.058543303,106.1851311
SETU,10,806,454,233,1493,51,71,265,387,1880,-6.345817722,106.6773853
SERPONG,20,774,424,241,1439,40,76,265,381,1820,-6.311254761,106.6807927
PAMULANG,30,2707,1641,1050,5398,118,150,685,953,6351,-6.339349381,106.7388451
CIPUTAT,40,1808,991,548,3347,148,132,557,837,4184,-6.308255148,106.7253048
CIPUTAT TIMUR,50,1289,709,460,2458,55,71,310,436,2894,-6.298500187,106.7551336
PONDOK AREN,60,1737,955,655,3347,146,116,472,734,4081,-6.266206221,106.7117143
SERPONG UTARA,70,501,283,195,979,27,56,147,230,1209,-6.253401819,106.6628942
MELAYA,10,1646,586,244,2476,39,122,333,494,2970,-8.245211344,114.5454079
NEGARA,20,2007,732,337,3076,77,176,406,659,3735,-8.330040949,114.5995161
JEMBRANA,21,1120,496,258,1874,29,89,170,288,2162,-8.318892772,114.6507738
MENDOYO,30,1059,486,273,1818,35,54,149,238,2056,-8.318302347,114.7415073
PEKUTATAN,40,387,156,81,624,14,33,54,101,725,-8.398721437,114.8681544
SELEMADEG,10,828,358,195,1381,28,28,118,174,1555,-8.458114014,115.0400228
SELEMADEG TIMUR,11,721,352,192,1265,11,24,116,151,1416,-8.489961801,115.0618231
SELEMADEG BARAT,12,621,229,110,960,10,25,84,119,1079,-8.457416098,114.9796834
KERAMBITAN,20,618,345,175,1138,16,12,120,148,1286,-8.526265048,115.0868212
TABANAN,30,898,466,274,1638,20,27,131,178,1816,-8.527852637,115.1192983
KEDIRI,40,1486,685,412,2583,71,74,276,421,3004,-8.580772845,115.1232445
MARGA,50,791,388,225,1404,25,33,117,175,1579,-8.463905962,115.1721729
BATURITI,60,1625,659,269,2553,80,151,305,536,3089,-8.33455324,115.176676
PENEBEL,70,538,236,122,896,36,42,90,168,1064,-8.396274443,115.1220474
PUPUAN,80,1525,523,131,2179,119,177,323,619,2798,-8.360267485,115.0084202
KUTA SELATAN,10,377,153,89,619,32,14,68,114,733,-8.81276452,115.1643724
KUTA,20,64,28,15,107,5,0,12,17,124,-8.726064533,115.1734382
KUTA UTARA,30,467,197,73,737,8,13,42,63,800,-8.647010278,115.1596133
MENGWI,40,2725,1080,445,4250,72,52,273,397,4647,-8.563294931,115.1702969
ABIANSEMAL,50,2345,964,434,3743,44,48,301,393,4136,-8.531364622,115.221311
PETANG,60,1049,386,216,1651,33,47,145,225,1876,-8.326916793,115.2211051
SUKAWATI,10,1646,735,450,2831,71,58,230,359,3190,-8.594442913,115.2737445
BLAHBATUH,20,1797,742,423,2962,48,72,256,376,3338,-8.571974906,115.3118662
GIANYAR,30,2363,1105,698,4166,178,109,415,702,4868,-8.526622395,115.3323936
TAMPAKSIRING,40,1614,717,381,2712,98,74,324,496,3208,-8.450521231,115.3066808
UBUD,50,2091,980,645,3716,67,34,226,327,4043,-8.518096426,115.2591432
TEGALLALANG,60,2266,991,489,3746,101,162,455,718,4464,-8.402104153,115.2926158
PAYANGAN,70,1701,836,461,2998,70,108,324,502,3500,-8.385508254,115.2566961
NUSAPENIDA,10,2383,978,510,3871,171,280,568,1019,4890,-8.736336495,115.5360903
BANJARANGKAN,20,1123,441,176,1740,25,45,153,223,1963,-8.518010514,115.3773324
KLUNGKUNG,30,1205,438,187,1830,37,67,195,299,2129,-8.530816965,115.4041891
DAWAN,40,971,367,175,1513,23,39,120,182,1695,-8.537759666,115.4466497
SUSUT,10,1134,479,201,1814,46,89,242,377,2191,-8.418738132,115.3408725
BANGLI,20,932,360,131,1423,38,74,228,340,1763,-8.3966281,115.3615987
TEMBUKU,30,1187,398,145,1730,57,124,326,507,2237,-8.414414677,115.3893505
KINTAMANI,40,3335,902,322,4559,617,795,1023,2435,6994,-8.243821668,115.3395235
RENDANG,10,588,172,60,820,82,120,170,372,1192,-8.369073615,115.4372758
SIDEMEN,20,1059,377,126,1562,112,156,268,536,2098,-8.483172845,115.4393702
MANGGIS,30,863,318,119,1300,45,85,156,286,1586,-8.491459066,115.5188216
KARANGASEM,40,3270,1162,462,4894,225,422,697,1344,6238,-8.44313159,115.6314455
ABANG,50,3670,1267,298,5235,432,665,1107,2204,7439,-8.366792695,115.6206894
BEBANDEM,60,1521,541,196,2258,107,210,370,687,2945,-8.405991378,115.5419972
SELAT,70,830,291,114,1235,320,190,247,757,1992,-8.417414617,115.4837352
KUBU,80,3645,933,251,4829,812,708,842,2362,7191,-8.269196176,115.5126392
GEROKGAK,10,4580,1572,625,6777,378,581,1167,2126,8903,-8.187875482,114.6667258
SERIRIT,20,3782,1290,486,5558,336,572,957,1865,7423,-8.246513154,114.9117765
BUSUNGBIU,30,1843,633,266,2742,66,127,296,489,3231,-8.308745107,114.9472609
BANJAR,40,3065,1021,353,4439,223,416,772,1411,5850,-8.236409263,115.036552
SUKASADA,50,3342,1029,415,4786,223,415,796,1434,6220,-8.202104319,115.1107113
BULELENG,60,3581,1382,625,5588,109,236,655,1000,6588,-8.129618986,115.1002146
SAWAN,70,2665,977,438,4080,162,281,617,1060,5140,-8.152653237,115.1733745
KUBUTAMBAHAN,80,3641,1158,478,5277,318,555,1052,1925,7202,-8.141253264,115.2183024
TEJAKULA,90,3015,1097,422,4534,154,386,684,1224,5758,-8.142524816,115.3374532
DENPASAR SELATAN,10,2119,722,293,3134,61,51,184,296,3430,-8.705325338,115.225919
DENPASAR TIMUR,20,2290,908,420,3618,64,65,253,382,4000,-8.643658007,115.2434174
DENPASAR BARAT,30,2666,992,398,4056,92,102,301,495,4551,-8.665643246,115.1934872
DENPASAR UTARA,31,2379,920,402,3701,87,118,285,490,4191,-8.625769498,115.2125234
SEKOTONG,10,5095,1659,783,7537,557,1029,1510,3096,10633,-8.803437215,115.972561
LEMBAR,11,3184,1306,752,5242,504,486,863,1853,7095,-8.74572116,116.0946711
GERUNG,20,4339,2008,1201,7548,347,481,1189,2017,9565,-8.691343161,116.1210959
LABU API,30,3467,1427,782,5676,240,313,810,1363,7039,-8.630482585,116.1150987
KEDIRI,40,3706,1746,1046,6498,218,296,899,1413,7911,-8.644895066,116.1424438
KURIPAN,41,2580,1159,638,4377,229,305,686,1220,5597,-8.677971863,116.1696715
NARMADA,50,4243,1863,910,7016,312,403,1036,1751,8767,-8.52879556,116.2594645
LINGSAR,51,3532,1500,899,5931,349,335,841,1525,7456,-8.52361906,116.201562
GUNUNG SARI,60,4275,2105,1424,7804,581,530,1111,2222,10026,-8.504288173,116.1332647
BATU LAYAR,61,2218,1057,644,3919,203,228,542,973,4892,-8.502833287,116.0727217
PRAYA BARAT,10,4632,2028,1326,7986,284,417,940,1641,9627,-8.81833787,116.2098913
PRAYA BARAT DAYA,11,3291,1353,866,5510,227,240,567,1034,6544,-8.781461091,116.1631827
PUJUT,20,5789,2813,1962,10564,346,434,1114,1894,12458,-8.851235166,116.310259
PRAYA TIMUR,30,2968,1313,794,5075,308,273,644,1225,6300,-8.787274003,116.3806871
JANAPRIA,40,4098,1459,734,6291,277,360,809,1446,7737,-8.709661637,116.393066
KOPANG,50,4490,1506,790,6786,236,452,1004,1692,8478,-8.60470212,116.3617184
PRAYA,60,5144,1831,1122,8097,173,290,899,1362,9459,-8.679379256,116.2840101
PRAYA TENGAH,61,2975,1281,874,5130,208,162,512,882,6012,-8.72756471,116.3212658
JONGGAT,70,4832,1948,1062,7842,259,381,992,1632,9474,-8.671069352,116.2211456
PRINGGARATA,80,3853,1468,726,6047,248,372,869,1489,7536,-8.607058746,116.240342
BATUKLIANG,90,3877,1474,649,6000,164,329,807,1300,7300,-8.618131294,116.3085367
BATUKLIANG UTARA,91,3505,1367,630,5502,229,326,666,1221,6723,-8.503882243,116.3437556
KERUAK,10,3376,977,485,4838,319,360,732,1411,6249,-8.759548359,116.483711
JEROWARU,11,3186,958,508,4652,254,264,584,1102,5754,-8.845354808,116.4802252
SAKRA,20,3656,1245,629,5530,173,300,760,1233,6763,-8.680042315,116.4748149
SAKRA BARAT,21,3407,1154,650,5211,177,238,594,1009,6220,-8.722919114,116.4738772
SAKRA TIMUR,22,2733,834,447,4014,163,175,404,742,4756,-8.714051357,116.5236615
TERARA,30,3358,1139,565,5062,285,519,1049,1853,6915,-8.650547618,116.4054373
MONTONG GADING,31,2715,893,503,4111,174,209,538,921,5032,-8.556150598,116.3971649
SIKUR,40,5297,1782,869,7948,290,472,1218,1980,9928,-8.565061108,116.4263461
MASBAGIK,50,5375,1824,946,8145,246,545,1308,2099,10244,-8.602334362,116.4548047
PRINGGASELA,51,3170,1125,594,4889,241,318,738,1297,6186,-8.529455599,116.4555032
SUKAMULIA,60,2130,708,409,3247,103,128,391,622,3869,-8.64089694,116.4927826
SURALAGA,61,3953,1503,980,6436,287,253,725,1265,7701,-8.617160812,116.5379925
SELONG,70,3280,1294,861,5435,272,287,702,1261,6696,-8.660470456,116.533681
LABUHAN HAJI,71,3189,1067,669,4925,220,269,689,1178,6103,-8.652225789,116.5831528
PRINGGABAYA,80,6615,2324,1314,10253,441,734,1703,2878,13131,-8.509061569,116.6369558
SUELA,81,2728,925,465,4118,264,273,604,1141,5259,-8.483140266,116.5842816
AIKMEL,90,7935,2892,1728,12555,595,738,1773,3106,15661,-8.519157485,116.5015896
WANASABA,91,2853,1109,811,4773,159,198,560,917,5690,-8.516833984,116.5417887
SEMBALUN,92,1536,553,322,2411,153,163,374,690,3101,-8.371028702,116.4976139
SAMBELIA,100,2399,700,349,3448,282,269,515,1066,4514,-8.346642172,116.6209152
LUNYUK,20,1216,350,172,1738,34,69,176,279,2017,-8.948656389,117.200747
ORONG TELU,21,398,144,74,616,22,33,71,126,742,-8.776913002,117.1750259
ALAS,50,1501,519,289,2309,117,134,285,536,2845,-8.576370511,117.0327932
ALAS BARAT,51,825,250,122,1197,39,75,168,282,1479,-8.534883019,116.93859
BUER,52,662,197,81,940,23,74,149,246,1186,-8.503944365,117.0811848
UTAN,61,1741,487,184,2412,108,276,420,804,3216,-8.437857683,117.1413535
RHEE,62,489,95,29,613,33,72,93,198,811,-8.494568934,117.2330931
BATULANTEH,70,975,145,50,1170,41,185,227,453,1623,-8.631514758,117.203602
SUMBAWA,80,1079,303,152,1534,35,73,194,302,1836,-8.473763589,117.4302264
LABUHAN BADAS,81,1284,351,141,1776,65,105,207,377,2153,-8.285588513,117.5147631
UNTER IWES,82,854,242,109,1205,42,76,141,259,1464,-8.546105312,117.3939239
MOYOHILIR,90,820,241,103,1164,30,57,144,231,1395,-8.507638203,117.5414842
MOYO UTARA,91,323,95,34,452,19,36,61,116,568,-8.444400272,117.4911311
MOYOHULU,100,715,217,59,991,39,63,144,246,1237,-8.643613124,117.4041404
ROPANG,110,289,45,3,337,4,22,47,73,410,-8.916676593,117.4949387
LENANGGUAR,111,328,86,48,462,10,17,54,81,543,-8.816735111,117.3627939
LANTUNG,112,147,39,5,191,4,8,26,38,229,-8.764129871,117.5239662
LAPE,121,649,158,77,884,28,42,116,186,1070,-8.575075783,117.6484296
LOPOK,122,751,226,98,1075,16,47,105,168,1243,-8.64611152,117.5496045
PLAMPANG,130,1277,354,143,1774,52,108,256,416,2190,-8.80900641,117.7866843
LABANGKA,131,685,175,95,955,32,72,99,203,1158,-8.897390787,117.7566007
MARONGE,132,557,141,68,766,40,66,104,210,976,-8.721561845,117.6662586
EMPANG,140,1046,311,161,1518,23,66,136,225,1743,-8.804009985,118.0069915
TARANO,141,1260,366,175,1801,26,74,177,277,2078,-8.742914333,118.1480983
HU'U,10,960,384,224,1568,43,36,108,187,1755,-8.781438152,118.4470212
PAJO,11,703,292,175,1170,26,29,89,144,1314,-8.638413442,118.4830663
DOMPU,20,2144,879,545,3568,123,113,373,609,4177,-8.491526378,118.4769821
WOJA,30,2987,1269,742,4998,177,164,526,867,5865,-8.531778257,118.397987
KILO,40,1043,400,231,1674,25,41,133,199,1873,-8.367272929,118.392587
KEMPO,50,959,381,231,1571,49,46,169,264,1835,-8.49590955,118.20411
MANGGALEWA,51,1596,669,371,2636,60,88,303,451,3087,-8.564388654,118.2946445
PEKAT,60,1807,530,256,2593,88,108,250,446,3039,-8.321052126,117.9155056
MONTA,10,2566,939,410,3915,81,100,340,521,4436,-8.718051391,118.6740369
PARADO,11,761,336,178,1275,36,17,82,135,1410,-8.792936993,118.5559245
BOLO,20,3041,1177,626,4844,70,132,439,641,5485,-8.504025091,118.6272351
MADA PANGGA,21,1173,626,371,2170,350,119,232,701,2871,-8.59665247,118.5577041
WOHA,30,2654,1053,510,4217,91,137,384,612,4829,-8.60418567,118.6467423
BELO,40,968,405,180,1553,41,53,168,262,1815,-8.617622264,118.7373367
PALIBELO,41,1361,553,298,2212,48,42,206,296,2508,-8.536790376,118.7331427
WAWO,50,1148,541,360,2049,44,30,163,237,2286,-8.559921546,118.8595578
LANGGUDU,51,2592,1107,471,4170,53,64,282,399,4569,-8.739922898,118.836803
LAMBITU,52,346,172,69,587,9,13,45,67,654,-8.571875429,118.7876833
SAPE,60,4311,1767,915,6993,175,260,772,1207,8200,-8.522181411,119.0104001
LAMBU,61,2734,1213,570,4517,108,202,449,759,5276,-8.663339366,119.041877
WERA,70,2235,939,478,3652,45,83,340,468,4120,-8.32337943,118.9753082
AMBALAWI,71,1399,603,363,2365,31,98,253,382,2747,-8.356285775,118.8079081
DONGGO,80,1551,750,354,2655,36,46,168,250,2905,-8.432629424,118.5656244
SOROMANDI,81,1258,502,307,2067,62,44,138,244,2311,-8.343946435,118.5892113
SANGGAR,90,854,354,217,1425,28,37,122,187,1612,-8.343122463,118.1833785
TAMBORA,91,717,224,109,1050,33,41,93,167,1217,-8.184830986,117.9871055
SEKONGKANG,10,381,144,92,617,56,23,82,161,778,-9.01272131,116.8723202
JEREWEH,20,269,95,46,410,27,17,36,80,490,-8.92278891,116.9491547
MALUK,21,223,92,36,351,9,9,25,43,394,-8.908094198,116.7655956
TALIWANG,30,1612,590,410,2612,121,104,235,460,3072,-8.738218414,116.8377342
BRANG ENE,31,232,71,54,357,10,28,27,65,422,-8.825274392,116.9263275
BRANG REA,40,617,259,194,1070,34,17,74,125,1195,-8.712735039,116.9891508
SETELUK,50,557,182,106,845,35,30,77,142,987,-8.640215872,116.8742638
POTO TANO,51,702,290,181,1173,55,72,138,265,1438,-8.601151256,116.8243171
PEMENANG,10,1691,868,729,3288,175,88,257,520,3808,-8.427699493,116.0813172
TANJUNG,20,2529,1174,719,4422,315,290,580,1185,5607,-8.416952461,116.1731302
GANGGA,30,2060,803,470,3333,195,217,451,863,4196,-8.364227999,116.2511957
KAYANGAN,40,3115,1090,593,4798,258,261,575,1094,5892,-8.308076977,116.3109781
BAYAN,50,3993,1337,669,5999,609,582,891,2082,8081,-8.302949457,116.4017827
AMPENAN,10,3031,1168,628,4827,246,238,610,1094,5921,-8.570931651,116.0837899
SEKARBELA,11,2028,808,432,3268,132,235,597,964,4232,-8.606671297,116.0862629
MATARAM,20,2288,870,515,3673,171,174,464,809,4482,-8.602679989,116.1098945
SELAPARANG,21,2124,795,424,3343,72,147,408,627,3970,-8.572197092,116.1074092
CAKRANEGARA,30,2440,948,627,4015,194,164,425,783,4798,-8.583262784,116.1316783
SANDUBAYA,31,3080,1176,586,4842,134,255,680,1069,5911,-8.598692245,116.1441338
RASANAE BARAT,10,467,180,105,752,16,28,83,127,879,-8.467897081,118.721035
MPUNDA,11,703,312,193,1208,24,41,141,206,1414,-8.472500409,118.7399965
RASANAE TIMUR,20,969,410,228,1607,23,57,213,293,1900,-8.488588369,118.8221559
RABA,21,1409,605,345,2359,41,75,309,425,2784,-8.457480061,118.8034977
ASAKOTA,30,1552,565,290,2407,38,99,340,477,2884,-8.412206712,118.743753
LAMBOYA,21,2208,843,374,3425,82,92,271,445,3870,-9.707266616,119.3546516
WANOKAKA,22,1737,678,375,2790,65,58,201,324,3114,-9.720941273,119.4538146
LABOYA BARAT,23,959,354,229,1542,75,44,116,235,1777,-9.709247161,119.2313301
LOLI,50,2458,906,478,3842,201,162,368,731,4573,-9.599389292,119.4250734
KOTA WAIKABUBAK,60,1580,612,362,2554,131,110,204,445,2999,-9.624184426,119.4471649
TANA RIGHU,72,1920,645,334,2899,91,62,204,357,3256,-9.476990608,119.4160714
LEWA,10,1559,670,475,2704,39,47,198,284,2988,-9.652545022,119.8977111
NGGAHA ORIANGU,11,1066,353,110,1529,62,85,145,292,1821,-9.718543685,120.0346269
LEWA TIDAHU,12,706,254,136,1096,40,36,74,150,1246,-9.788515937,119.7890128
KATALA HAMU LINGU,13,458,125,19,602,13,33,77,123,725,-9.84908766,119.9245126
TABUNDUNG,20,878,219,59,1156,44,74,153,271,1427,-9.95487934,120.0670864
PINUPAHAR,21,636,224,78,938,15,48,110,173,1111,-10.09534896,120.1109345
PABERIWAI,30,573,131,22,726,29,64,112,205,931,-10.03664736,120.412719
KARERA,31,771,235,46,1052,48,46,120,214,1266,-10.17455029,120.2549114
MATAWAI LA PAWU,32,678,210,45,933,29,43,95,167,1100,-10.01009312,120.278937
KAHAUNGU ETI,33,808,241,73,1122,53,72,135,260,1382,-9.871311475,120.4717465
MAHU,34,360,107,27,494,75,67,103,245,739,-10.09078701,120.4923332
NGADU NGALA,35,494,127,33,654,32,61,115,208,862,-10.19294725,120.4021791
PAHUNGA LODU,40,1227,350,172,1749,86,82,162,330,2079,-10.12407771,120.6810203
WULA WAIJELU,41,820,220,54,1094,22,41,101,164,1258,-10.21914441,120.5263113
RINDI,51,859,256,78,1193,44,94,176,314,1507,-10.00306296,120.6913401
UMALULU,52,1484,482,302,2268,138,151,243,532,2800,-9.876890507,120.584034
PANDAWAI,60,1634,601,349,2584,57,81,201,339,2923,-9.747334413,120.4019789
KAMBATA MAPAMBUHANG,61,407,142,27,576,29,38,66,133,709,-9.846314703,120.2340174
KOTA WAINGAPU,70,1858,746,565,3169,75,106,289,470,3639,-9.722522422,120.1658671
KAMBERA,71,1796,767,514,3077,46,75,212,333,3410,-9.70429425,120.2720875
HAHARU,80,812,222,95,1129,14,34,101,149,1278,-9.465622033,119.9835046
KANATANG,81,914,327,233,1474,21,48,117,186,1660,-9.576290675,120.1620021
SEMAU,100,488,120,100,708,52,20,71,143,851,-10.17955606,123.4255235
SEMAU SELATAN,101,533,149,98,780,63,38,67,168,948,-10.28116653,123.3606381
KUPANG BARAT,110,363,153,75,591,11,21,50,82,673,-10.28366675,123.5257619
NEKAMESE,111,404,138,52,594,22,21,50,93,687,-10.29721881,123.6371041
KUPANG TENGAH,120,1329,479,264,2072,97,122,218,437,2509,-10.1434324,123.7248635
TAEBENU,121,722,298,177,1197,52,50,85,187,1384,-10.20863746,123.7278513
AMARASI,130,1031,452,304,1787,58,31,120,209,1996,-10.21662167,123.882446
AMARASI BARAT,131,886,273,152,1311,34,57,109,200,1511,-10.29945694,123.7383922
AMARASI SELATAN,132,515,186,89,790,26,59,70,155,945,-10.28919884,123.8651544
AMARASI TIMUR,133,844,285,140,1269,22,40,94,156,1425,-10.18286711,124.0745671
KUPANG TIMUR,140,2219,841,548,3608,208,179,375,762,4370,-10.0945254,123.8219953
AMABI OEFETO TIMUR,141,1349,439,260,2048,109,84,156,349,2397,-10.09723919,124.0904523
AMABI OEFETO,142,553,170,84,807,24,28,70,122,929,-10.14743857,123.9192462
SULAMU,150,760,212,101,1073,78,90,155,323,1396,-9.99173997,123.7167356
FATULEU,160,1842,552,321,2715,209,165,334,708,3423,-10.01987237,123.9725384
FATULEU TENGAH,161,565,174,75,814,49,54,88,191,1005,-9.923718314,123.8594408
FATULEU BARAT,162,823,272,115,1210,51,75,161,287,1497,-9.858411608,123.727245
TAKARI,170,1933,539,220,2692,141,161,290,592,3284,-9.869067317,123.9985605
AMFOANG SELATAN,180,866,263,176,1305,78,52,119,249,1554,-9.726590858,123.9160374
AMFOANG BARAT DAYA,181,423,162,72,657,30,31,54,115,772,-9.699030076,123.7533492
AMFOANG TENGAH,182,479,187,64,730,69,20,81,170,900,-9.603033775,124.0362217
AMFOANG UTARA,190,712,283,150,1145,83,32,78,193,1338,-9.514915523,123.885427
AMFOANG BARAT LAUT,191,1099,461,190,1750,56,63,155,274,2024,-9.612580677,123.8261772
AMFOANG TIMUR,192,653,154,96,903,158,111,158,427,1330,-9.437259232,124.0355448
MOLLO UTARA,10,2215,619,234,3068,230,264,459,953,4021,-9.721549266,124.2025673
FATUMNASI,11,605,155,45,805,84,75,112,271,1076,-9.582465257,124.1913944
TOBU,12,1023,267,98,1388,102,79,147,328,1716,-9.616870348,124.2825964
NUNBENA,13,346,96,33,475,94,45,83,222,697,-9.645315225,124.1168501
MOLLO SELATAN,20,864,298,144,1306,86,50,148,284,1590,-9.839510771,124.2187311
POLEN,21,1261,410,137,1808,386,201,315,902,2710,-9.663011043,124.3981234
MOLLO BARAT,22,636,161,56,853,108,110,156,374,1227,-9.852091158,124.1245871
MOLLO TENGAH,23,800,227,97,1124,80,90,161,331,1455,-9.776758096,124.2782352
KOTA SOE,30,911,348,214,1473,24,45,113,182,1655,-9.862299071,124.2800518
AMANUBAN BARAT,40,2128,686,362,3176,123,176,383,682,3858,-9.888325039,124.3300893
BATU PUTIH,41,1295,464,171,1930,92,74,188,354,2284,-9.940372916,124.180971
KUATNANA,42,1881,583,310,2774,71,88,231,390,3164,-9.84655582,124.4012338
AMANUBAN SELATAN,50,2363,724,325,3412,377,235,422,1034,4446,-10.06234029,124.254604
NOEBEBA,51,1339,328,92,1759,32,109,177,318,2077,-9.977180733,124.3292009
KUAN FATU,60,2178,614,303,3095,153,156,299,608,3703,-10.00107574,124.4344832
KUALIN,61,2650,852,396,3898,86,120,361,567,4465,-10.10656466,124.4114126
AMANUBAN TENGAH,70,1171,371,188,1730,68,73,172,313,2043,-9.871092414,124.4772002
KOLBANO,71,1828,415,157,2400,47,108,216,371,2771,-9.986405998,124.523188
OENINO,72,1052,240,103,1395,111,126,148,385,1780,-9.742343761,124.4406512
AMANUBAN TIMUR,80,1920,470,270,2660,123,86,173,382,3042,-9.703157623,124.5824545
FAUTMOLO,81,849,163,52,1064,88,65,115,268,1332,-9.780733913,124.5661966
FATUKOPA,82,558,144,54,756,118,95,126,339,1095,-9.65074603,124.6247655
KIE,90,2426,746,402,3574,127,121,251,499,4073,-9.856574148,124.5437844
KOT'OLIN,91,1226,355,137,1718,92,95,156,343,2061,-9.947808964,124.6002062
AMANATUN SELATAN,100,1636,616,310,2562,148,126,328,602,3164,-9.842480209,124.6218068
BOKING,101,1048,343,200,1591,88,63,122,273,1864,-9.819726563,124.7405039
NUNKOLO,102,1443,550,376,2369,273,119,161,553,2922,-9.889378676,124.684015
NOEBANA,103,593,191,148,932,40,49,108,197,1129,-9.773307282,124.6467787
SANTIAN,104,627,292,187,1106,173,74,124,371,1477,-9.77962906,124.7065137
AMANATUN UTARA,110,1336,448,268,2052,195,180,239,614,2666,-9.692167205,124.6983365
TOIANAS,111,1264,427,206,1897,126,103,198,427,2324,-9.705823283,124.7750329
KOKBAUN,112,385,125,80,590,69,54,75,198,788,-9.628573712,124.759145
MIOMAFFO BARAT,10,1072,328,176,1576,45,39,115,199,1775,-9.550445938,124.3315626
MIOMAFFO TENGAH,11,415,98,47,560,13,16,33,62,622,-9.528897446,124.424887
MUSI,12,184,41,15,240,3,2,16,21,261,-9.488545148,124.3849747
MUTIS,13,839,183,104,1126,41,42,101,184,1310,-9.448128321,124.2175888
MIOMAFFO TIMUR,20,795,195,93,1083,28,42,77,147,1230,-9.380294444,124.4900077
NOEMUTI,21,691,186,121,998,24,40,67,131,1129,-9.600260795,124.4938614
BIKOMI SELATAN,22,808,249,166,1223,42,32,88,162,1385,-9.536742092,124.564327
BIKOMI TENGAH,23,455,91,58,604,32,23,70,125,729,-9.436077674,124.4214459
BIKOMI NILULAT,24,484,129,63,676,16,27,35,78,754,-9.459568092,124.3591105
BIKOMI UTARA,25,452,142,73,667,13,5,27,45,712,-9.373424234,124.4188835
NAIBENU,26,401,104,48,553,11,20,35,66,619,-9.281619952,124.4839536
NOEMUTI TIMUR,27,258,62,25,345,12,13,26,51,396,-9.588593677,124.5858565
KOTA KEFAMENANU,30,1067,319,179,1565,71,88,175,334,1899,-9.467778366,124.4967178
INSANA,40,1396,451,240,2087,74,49,125,248,2335,-9.469605193,124.6980811
INSANA UTARA,41,773,221,156,1150,28,30,104,162,1312,-9.238438384,124.5473232
INSANA BARAT,42,824,235,96,1155,39,21,48,108,1263,-9.475217857,124.5768801
INSANA TENGAH,43,718,206,117,1041,18,23,82,123,1164,-9.351383997,124.6028426
INSANA FAFINESU,44,492,132,92,716,16,37,70,123,839,-9.3602767,124.5710375
BIBOKI SELATAN,50,658,196,107,961,19,34,84,137,1098,-9.340858679,124.6928644
BIBOKI TANPAH,51,469,129,57,655,12,21,47,80,735,-9.360164578,124.7697836
BIBOKI MOENLEU,52,539,137,110,786,70,56,103,229,1015,-9.221270836,124.6464565
BIBOKI UTARA,60,809,265,156,1230,27,33,91,151,1381,-9.294832567,124.8116874
BIBOKI ANLEU,61,1354,421,265,2040,124,118,236,478,2518,-9.134509086,124.7381736
BIBOKI FEOTLEU,62,488,87,12,587,27,28,67,122,709,-9.228390644,124.7820704
MALAKA BARAT,10,2068,675,448,3191,148,125,173,446,3637,-9.654391797,124.9208742
RINHAT,11,1374,273,97,1744,274,174,170,618,2362,-9.598690532,124.7401529
WEWIKU,12,1885,538,261,2684,159,131,201,491,3175,-9.715182545,124.8337091
WELIMAN,13,1808,505,308,2621,331,203,240,774,3395,-9.624147224,124.8666217
MALAKA TENGAH,20,2303,636,381,3320,275,250,301,826,4146,-9.567708264,124.8985068
SASITA MEAN,21,672,181,91,944,49,70,81,200,1144,-9.492706075,124.8238283
BOTIN LEOBELE,22,456,68,18,542,36,48,57,141,683,-9.495346131,124.9037097
IO KUFEU,23,740,227,135,1102,270,147,191,608,1710,-9.509102901,124.7718046
MALAKA TIMUR,30,798,164,80,1042,80,92,111,283,1325,-9.426977098,124.9125545
LAEN MANEN,31,1199,224,50,1473,67,139,230,436,1909,-9.412057251,124.8358922
RAI MANUK,32,1439,417,242,2098,256,138,179,573,2671,-9.344914168,124.9074803
KOBALIMA,40,1370,432,298,2100,127,154,244,525,2625,-9.470280794,124.9876612
KOBALIMA TIMUR,41,522,127,76,725,59,49,57,165,890,-9.387958919,125.0369402
TASIFETO BARAT,50,1478,458,233,2169,125,174,295,594,2763,-9.209693554,124.8861807
KAKULUK MESAK,51,1064,288,208,1560,272,208,268,748,2308,-9.041665008,124.8605517
NANAET DUBESI,52,397,139,58,594,75,54,71,200,794,-9.287227182,124.966226
ATAMBUA,60,846,234,160,1240,116,122,149,387,1627,-9.098527584,124.9075751
ATAMBUA BARAT,61,385,114,115,614,9,6,29,44,658,-9.09484637,124.8748183
ATAMBUA SELATAN,62,668,196,130,994,81,77,113,271,1265,-9.122108315,124.8845594
TASIFETO TIMUR,70,1517,348,161,2026,215,219,267,701,2727,-9.109944563,124.961508
RAIHAT,71,921,248,106,1275,385,164,182,731,2006,-9.033763879,125.1141566
LASIOLAT,72,664,179,92,935,43,74,108,225,1160,-9.070406569,125.0493083
LAMAKNEN,80,770,102,37,909,90,107,116,313,1222,-9.086341847,125.1265187
LAMAKNEN SELATAN,81,971,177,45,1193,102,112,120,334,1527,-9.150946515,125.1156394
PANTAR,10,707,182,94,983,108,92,159,359,1342,-8.254720469,124.2399501
PANTAR BARAT,11,769,266,140,1175,44,44,129,217,1392,-8.361591089,124.0635191
PANTAR TIMUR,12,1233,371,164,1768,85,144,266,495,2263,-8.326638099,124.2414087
PANTAR BARAT LAUT,13,380,76,22,478,22,49,59,130,608,-8.380777606,123.9681005
PANTAR TENGAH,14,1108,408,119,1635,61,54,134,249,1884,-8.451338158,124.1237868
ALOR BARAT DAYA,20,2099,710,311,3120,196,231,361,788,3908,-8.358011492,124.4741539
MATARU,21,699,221,68,988,80,79,160,319,1307,-8.367369907,124.6289504
ALOR SELATAN,30,895,194,44,1133,114,135,206,455,1588,-8.322154205,124.7242489
ALOR TIMUR,40,726,214,54,994,77,78,164,319,1313,-8.245638282,125.0095202
ALOR TIMUR LAUT,41,803,234,52,1089,67,91,118,276,1365,-8.220283529,124.8069892
PUREMAN,42,358,99,24,481,74,47,70,191,672,-8.335505072,124.8762521
TELUK MUTIARA,50,1663,704,424,2791,65,72,239,376,3167,-8.228902976,124.5395494
KABOLA,51,597,206,125,928,66,61,124,251,1179,-8.159247979,124.5539256
ALOR BARAT LAUT,60,1747,632,275,2654,71,95,268,434,3088,-8.199227563,124.4506724
ALOR TENGAH UTARA,61,725,259,115,1099,80,61,115,256,1355,-8.235923894,124.6321616
PULAU PURA,62,370,107,21,498,11,26,65,102,600,-8.300653179,124.3461716
LEMBUR,63,425,111,34,570,34,59,69,162,732,-8.198974217,124.7145268
NAGAWUTUNG,10,840,268,89,1197,22,55,135,212,1409,-8.499274648,123.3102576
WULANDONI,11,664,256,44,964,55,54,108,217,1181,-8.529447046,123.4239178
ATADEI,20,388,77,6,471,22,44,54,120,591,-8.476316143,123.5019898
ILE APE,30,649,239,65,953,32,51,80,163,1116,-8.291580558,123.4512118
ILE APE TIMUR,31,296,101,3,400,8,21,40,69,469,-8.270527639,123.5236619
LEBATUKAN,40,840,301,58,1199,34,37,93,164,1363,-8.366710018,123.5975278
NUBATUKAN,50,1200,386,230,1816,93,110,185,388,2204,-8.408516333,123.4050288
OMESURI,60,1503,486,112,2101,73,212,287,572,2673,-8.277262286,123.7108573
BUYASARI,70,1803,608,225,2636,91,185,292,568,3204,-8.229065219,123.8359024
WULANGGITANG,10,1096,369,161,1626,48,78,188,314,1940,-8.529908969,122.7110529
TITEHENA,11,940,203,40,1183,26,79,108,213,1396,-8.39131952,122.7723076
ILEBURA,12,460,99,28,587,24,53,91,168,755,-8.540726631,122.7928268
TANJUNG BUNGA,20,1360,417,138,1915,68,125,179,372,2287,-8.149783686,122.8590147
LEWO LEMA,21,478,140,26,644,15,34,73,122,766,-8.270817836,122.9076999
LARANTUKA,30,1209,411,241,1861,35,71,161,267,2128,-8.327586733,122.9532202
ILE MANDIRI,31,787,246,137,1170,68,97,137,302,1472,-8.279377419,122.9608989
DEMON PAGONG,32,404,130,32,566,14,23,39,76,642,-8.381500515,122.8549705
SOLOR BARAT,40,828,208,80,1116,16,50,57,123,1239,-8.530589418,122.9336347
SOLOR SELATAN,41,553,196,65,814,23,43,57,123,937,-8.489168277,122.9925593
SOLOR TIMUR,50,1290,355,87,1732,65,125,156,346,2078,-8.45467405,123.0917528
ADONARA BARAT,60,914,248,107,1269,51,94,160,305,1574,-8.305442503,123.0950341
WOTAN ULU MADO,61,827,147,32,1006,47,92,123,262,1268,-8.370189729,123.0513819
ADONARA TENGAH,62,886,262,62,1210,43,77,135,255,1465,-8.316111107,123.1530351
ADONARA TIMUR,70,1731,512,251,2494,87,157,255,499,2993,-8.361218646,123.1754199
ILE BOLENG,71,977,333,146,1456,39,43,112,194,1650,-8.364704561,123.2694801
WITIHAMA,72,923,301,109,1333,72,78,114,264,1597,-8.289256668,123.2829939
KELUBAGOLIT,73,498,135,63,696,28,46,58,132,828,-8.293136652,123.2306862
ADONARA,74,761,198,66,1025,42,83,104,229,1254,-8.260883716,123.1934998
PAGA,10,1174,406,196,1776,43,97,126,266,2042,-8.741565823,122.0247122
MEGO,11,1143,397,247,1787,157,151,193,501,2288,-8.672026832,122.0532228
TANA WAWO,12,1164,396,175,1735,108,148,286,542,2277,-8.691944804,121.9747562
LELA,20,741,238,86,1065,20,66,91,177,1242,-8.721859866,122.1721128
BOLA,30,656,197,71,924,61,83,99,243,1167,-8.728300327,122.2809226
DORENG,31,1283,421,159,1863,48,89,187,324,2187,-8.717574608,122.3751918
MAPITARA,32,803,215,89,1107,92,90,195,377,1484,-8.69890515,122.4702908
TALIBURA,40,1697,549,176,2422,69,117,290,476,2898,-8.479396677,122.6002678
WAIGETE,41,2213,723,333,3269,257,285,429,971,4240,-8.639481188,122.4491519
WAIBLAMA,42,983,232,140,1355,62,120,188,370,1725,-8.589948267,122.594885
KEWAPANTE,50,864,279,128,1271,41,65,100,206,1477,-8.667654122,122.2933961
HEWOKLOANG,51,737,190,110,1037,27,51,90,168,1205,-8.690411853,122.3231221
KANGAE,52,780,259,116,1155,29,64,124,217,1372,-8.674123043,122.2577008
PALUE,61,930,292,77,1299,66,94,111,271,1570,-8.324656133,121.7114981
KOTING,62,170,59,30,259,21,14,22,57,316,-8.687812474,122.1969065
NELLE,63,235,81,27,343,13,39,44,96,439,-8.680357259,122.2165388
NITA,70,1217,485,223,1925,43,105,172,320,2245,-8.654819633,122.1300872
MAGEPANDA,71,854,259,88,1201,84,103,185,372,1573,-8.570313849,122.0543665
ALOK,80,574,186,70,830,35,71,100,206,1036,-8.453495353,122.2183895
ALOK BARAT,81,556,172,54,782,113,102,133,348,1130,-8.595326038,122.163172
ALOK TIMUR,82,928,297,127,1352,47,111,153,311,1663,-8.502058767,122.3547954
NANGAPANDA,10,1649,566,304,2519,36,69,167,272,2791,-8.748315436,121.4806051
PULAU ENDE,11,755,292,49,1096,14,46,131,191,1287,-8.882572911,121.5219198
MAUKARO,12,466,141,81,688,26,23,49,98,786,-8.650999256,121.5609016
ENDE,20,1417,402,140,1959,46,90,203,339,2298,-8.741003877,121.6277748
ENDE SELATAN,30,1019,429,249,1697,46,90,173,309,2006,-8.876214495,121.6461485
ENDE TIMUR,31,579,249,164,992,13,45,116,174,1166,-8.798277452,121.670703
ENDE TENGAH,32,435,207,139,781,12,28,81,121,902,-8.834213112,121.6577886
ENDE UTARA,33,1045,348,243,1636,52,82,172,306,1942,-8.818527928,121.629527
NDONA,40,818,247,156,1221,34,88,169,291,1512,-8.836853374,121.7409161
NDONA TIMUR,41,552,167,20,739,32,35,51,118,857,-8.807741202,121.7764174
WOLOWARU,50,1302,545,236,2083,85,133,240,458,2541,-8.77573912,121.8853838
WOLOJITA,51,557,204,91,852,9,19,63,91,943,-8.817134201,121.8370632
LIO TIMUR,52,805,293,99,1197,27,53,94,174,1371,-8.765985252,121.9506587
KELIMUTU,53,539,167,32,738,26,55,71,152,890,-8.720148448,121.8480495
NDORI,54,392,130,34,556,24,33,103,160,716,-8.806955877,121.9322903
MAUROLE,60,1042,367,176,1585,51,82,151,284,1869,-8.531870471,121.7939081
KOTABARU,61,1029,376,130,1535,53,49,116,218,1753,-8.57183861,121.9426004
DETUKELI,62,767,312,132,1211,23,33,88,144,1355,-8.611681242,121.8323415
LEPEMBUSU KELISOKE,63,696,237,69,1002,35,54,99,188,1190,,
DETUSOKO,70,1138,283,59,1480,26,47,149,222,1702,-8.718973162,121.7643341
WEWARIA,71,1490,512,206,2208,80,130,266,476,2684,-8.594663083,121.6848862
AIMERE,10,1384,495,250,2129,71,59,133,263,2392,-8.830788433,120.902594
JEREBUU,11,454,148,56,658,31,11,31,73,731,-8.893687383,121.0048533
BAJAWA,20,1153,391,198,1742,74,123,200,397,2139,-8.802175811,120.9700218
GOLEWA,30,2115,588,301,3004,106,171,254,531,3535,-8.84190076,121.0650823
BAJAWA UTARA,70,434,97,24,555,101,91,92,284,839,-8.705024388,120.9463525
SOA,71,726,239,123,1088,52,70,126,248,1336,-8.70353419,121.0669187
RIUNG,80,912,237,107,1256,48,82,118,248,1504,-8.468431784,121.0589679
RIUNG BARAT,81,604,181,124,909,3,33,74,110,1019,-8.538720312,120.9395001
WOLOMEZE,82,379,68,11,458,15,39,63,117,575,-8.612927448,121.0428352
SATAR MESE,40,3992,1065,184,5241,119,462,680,1261,6502,-8.730353813,120.4377286
SATAR MESE BARAT,41,3558,954,204,4716,113,327,557,997,5713,-8.777725723,120.326211
LANGKE REMBONG,110,2551,828,506,3885,38,71,217,326,4211,-8.618392619,120.4633197
RUTENG,120,4787,1382,469,6638,81,289,545,915,7553,-8.595259075,120.380708
WAE RII,121,3709,1187,597,5493,90,211,466,767,6260,-8.575140382,120.4822878
LELAK,122,1503,412,67,1982,39,129,172,340,2322,-8.624678492,120.3128812
RAHONG UTARA,123,3480,1016,208,4704,115,313,537,965,5669,-8.522214805,120.3977768
CIBAL,130,5370,1625,362,7357,128,395,671,1194,8551,-8.46812627,120.4742166
REOK,140,3754,794,270,4818,145,262,406,813,5631,-8.35083458,120.3809487
ROTE BARAT DAYA,10,2526,791,464,3781,80,104,306,490,4271,-10.87574176,122.9563174
ROTE BARAT LAUT,20,1866,501,332,2699,75,96,215,386,3085,-10.78856557,122.9313147
LOBALAIN,30,1480,386,238,2104,26,46,118,190,2294,-10.78663195,123.0783081
ROTE TENGAH,40,242,57,30,329,6,16,41,63,392,-10.70413059,123.1539388
ROTE SELATAN,41,316,72,49,437,9,13,44,66,503,-10.78815419,123.194441
PANTAI BARU,50,687,177,61,925,21,41,115,177,1102,-10.66435895,123.2560512
ROTE TIMUR,60,1703,422,208,2333,111,202,295,608,2941,-10.57421381,123.3425582
ROTE BARAT,70,1042,322,147,1511,46,50,106,202,1713,-10.85522568,122.831524
KOMODO,10,2304,614,321,3239,149,173,234,556,3795,-8.625120367,119.6824633
BOLENG,11,1945,396,141,2482,58,212,337,607,3089,-8.481347606,120.0432933
SANO NGGOANG,20,3084,673,198,3955,60,141,245,446,4401,-8.64976324,120.0004944
LEMBOR,30,5686,1134,237,7057,174,505,731,1410,8467,-8.747756249,120.1291116
WELAK,31,2619,587,206,3412,63,292,391,746,4158,-8.619375842,120.1997227
KUWUS,40,5635,1460,398,7493,100,461,721,1282,8775,-8.51520026,120.3102118
MACANG PACAR,50,2689,654,192,3535,89,216,434,739,4274,-8.427426139,120.2075565
KATIKUTANA,10,739,274,148,1161,29,42,99,170,1331,-9.583795765,119.5360575
KATIKUTANA SELATAN,11,1218,514,253,1985,26,24,117,167,2152,-9.714248872,119.6140849
UMBU RATU NGGAY BARAT,20,1690,597,247,2534,65,77,239,381,2915,-9.57062883,119.6272856
UMBU RATU NGGAY,30,1396,424,200,2020,113,83,213,409,2429,-9.507027312,119.7734105
MAMBORO,40,1505,538,286,2329,147,103,152,402,2731,-9.425109638,119.5311418
KODI BANGEDO,10,5264,2001,1138,8403,1058,544,1126,2728,11131,-9.640900068,119.0730726
KODI,20,4489,1524,697,6710,494,554,996,2044,8754,-9.557781922,118.9821528
KODI UTARA,30,7611,2561,1264,11436,868,635,1140,2643,14079,-9.488614585,119.060732
WEWEWA SELATAN,40,2656,813,436,3905,105,101,252,458,4363,-9.600676409,119.1783226
WEWEWA BARAT,50,5241,1888,912,8041,517,277,496,1290,9331,-9.488924304,119.1941668
WEWEWA TIMUR,60,5616,1959,934,8509,269,281,631,1181,9690,-9.580904963,119.3019184
WEWEWA UTARA,70,1259,409,188,1856,67,83,144,294,2150,-9.511094525,119.3617211
LOURA,80,1952,646,359,2957,143,160,273,576,3533,-9.41762864,119.290234
MAUPONGGO,10,1104,435,259,1798,32,46,107,185,1983,-8.85669117,121.1937787
KEO TENGAH,20,885,291,115,1291,28,54,104,186,1477,-8.871846074,121.2978256
NANGARORO,30,1234,464,205,1903,37,89,186,312,2215,-8.768815203,121.3442365
BOAWAE,40,2627,895,343,3865,73,169,286,528,4393,-8.72655282,121.1781516
AESESA SELATAN,50,754,270,146,1170,18,79,161,258,1428,-8.660263799,121.2399742
AESESA,60,1355,523,305,2183,65,103,179,347,2530,-8.568226916,121.2623973
WOLOWAE,70,306,105,71,482,9,21,36,66,548,-8.622459303,121.4318463
BORONG,10,5834,1801,416,8051,184,551,885,1620,9671,-8.71616233,120.5829191
KOTA KOMBA,20,4248,1354,468,6070,136,215,430,781,6851,-8.758361667,120.7365262
ELAR,30,3273,870,291,4434,80,240,379,699,5133,-8.530046139,120.8220098
SAMBI RAMPAS,40,2401,799,369,3569,45,137,237,419,3988,-8.434469364,120.7325496
POCO RANAKA,50,5710,2105,577,8392,245,389,715,1349,9741,-8.562640667,120.5935396
LAMBA LEDA,60,3212,1072,436,4720,147,276,401,824,5544,-8.376571135,120.5809729
RAIJUA,10,773,246,74,1093,53,84,135,272,1365,-10.62377901,121.5712304
HAWU MEHARA,20,1964,708,362,3034,108,151,319,578,3612,-10.57924581,121.7501593
SABU LIAE,30,978,391,186,1555,52,83,167,302,1857,-10.58943809,121.8691817
SABU BARAT,40,2774,1055,525,4354,141,297,520,958,5312,-10.51464829,121.8566583
SABU TENGAH,50,991,363,199,1553,36,62,135,233,1786,-10.481573,121.9382502
SABU TIMUR,60,763,305,171,1239,39,58,116,213,1452,-10.49950213,121.9773343
ALAK,10,2939,1085,626,4650,72,95,292,459,5109,-10.2248395,123.5776516
MAULAFA,20,2931,1189,759,4879,72,66,276,414,5293,-10.2100685,123.6296697
OEBOBO,30,2545,855,536,3936,54,54,249,357,4293,-10.17213944,123.6123282
KOTA RAJA,31,1597,551,378,2526,28,41,160,229,2755,,
KELAPA LIMA,40,2150,790,478,3418,69,63,185,317,3735,-10.14969923,123.6396585
KOTA LAMA,41,799,299,150,1248,15,28,73,116,1364,,
SELAKAU,10,2007,535,160,2702,124,333,518,975,3677,1.043744733,109.0084654
SELAKAU TIMUR,11,381,107,72,560,219,164,153,536,1096,1.042256159,109.1253383
PEMANGKAT,20,1554,432,171,2157,87,219,315,621,2778,1.160323238,108.9769663
SEMPARUK,21,630,180,86,896,42,58,80,180,1076,1.151854764,109.0741838
SALATIGA,22,955,284,111,1350,58,92,196,346,1696,1.112518251,109.0026666
TEBAS,30,2124,670,239,3033,88,218,452,758,3791,1.132729268,109.2279489
TEKARANG,31,639,196,62,897,44,86,153,283,1180,1.286234174,109.1155271
SAMBAS,40,1153,344,137,1634,113,168,279,560,2194,1.331490644,109.3107147
SUBAH,41,508,178,53,739,27,35,107,169,908,1.195367484,109.4417385
SEBAWI,42,519,147,41,707,21,57,85,163,870,1.266140802,109.2359874
SAJAD,43,415,145,82,642,45,67,125,237,879,1.368919668,109.4159005
JAWAI,50,1227,370,120,1717,77,201,298,576,2293,1.392945356,109.0745062
JAWAI SELATAN,51,804,221,80,1105,27,70,153,250,1355,1.242332694,109.0287813
TELUK KERAMAT,60,884,263,98,1245,79,201,216,496,1741,1.452152783,109.2014355
GALING,61,437,150,41,628,35,59,115,209,837,1.594035055,109.3666319
TANGARAN,62,435,118,50,603,47,76,126,249,852,1.541731963,109.1444412
SEJANGKUNG,70,736,167,59,962,108,150,230,488,1450,1.424626915,109.4975928
SAJINGAN BESAR,80,278,92,47,417,14,37,58,109,526,1.636425953,109.5788038
PALOH,90,604,136,60,800,44,93,129,266,1066,1.830533217,109.4156354
SUNGAI RAYA,10,488,186,53,727,31,42,105,178,905,0.592471104,108.9655864
CAPKALA,11,602,177,68,847,47,83,131,261,1108,0.648341808,109.0292613
SUNGAI RAYA KEPULAUAN,12,766,204,64,1034,46,108,195,349,1383,0.749896712,108.9206238
SAMALANTAN,30,541,151,38,730,214,209,274,697,1427,0.791644612,109.2495295
MONTERADO,31,1374,482,231,2087,124,164,320,608,2695,0.787582041,109.1225652
LEMBAH BAWANG,32,246,106,49,401,12,12,27,51,452,0.939040061,109.2758178
BENGKAYANG,40,619,199,80,898,52,104,154,310,1208,0.850017597,109.4922979
TERIAK,41,996,440,301,1737,229,82,172,483,2220,0.794612359,109.5825003
SUNGAI BETUNG,42,611,270,200,1081,194,87,74,355,1436,0.828523409,109.3804893
LEDO,50,482,194,67,743,40,35,110,185,928,1.006218499,109.5897876
SUTI SEMARANG,51,360,99,48,507,20,34,63,117,624,0.918914157,109.7461483
LUMAR,52,197,79,42,318,12,10,21,43,361,0.972775343,109.4272823
SANGGAU LEDO,60,324,109,41,474,14,40,62,116,590,1.144143719,109.6154208
TUJUHBELAS,61,234,115,42,391,6,19,77,102,493,1.030237545,109.7911673
SELUAS,70,871,336,197,1404,139,84,166,389,1793,1.209932592,109.7505469
JAGOI BABANG,80,509,201,89,799,69,53,122,244,1043,1.383434619,109.7804131
SIDING,81,735,195,94,1024,105,98,176,379,1403,1.157599263,109.9816602
SEBANGKI,20,1658,674,308,2640,108,164,428,700,3340,0.162244599,109.5952128
NGABANG,30,1710,653,275,2638,113,195,513,821,3459,0.350163894,109.8945415
JELIMPO,31,1242,507,226,1975,106,176,372,654,2629,0.377904259,110.1006532
SENGAH TEMILA,40,4575,2275,1412,8262,158,199,832,1189,9451,0.346146931,109.6893019
MANDOR,50,1900,795,466,3161,168,163,359,690,3851,0.322421074,109.4022486
MENJALIN,60,1523,641,314,2478,95,111,310,516,2994,0.467759074,109.3420787
MEMPAWAH HULU,70,3767,1701,944,6412,144,260,875,1279,7691,0.647592886,109.3621978
SOMPAK,71,1596,739,396,2731,75,91,413,579,3310,0.499601146,109.4956563
MENYUKE,80,2132,969,587,3688,157,148,442,747,4435,0.582583742,109.6659107
BANYUKE HULU,81,1217,570,408,2195,90,77,212,379,2574,0.641067626,109.5402989
MERANTI,90,560,224,111,895,105,108,180,393,1288,0.738478195,109.7418514
KUALA BEHE,100,988,453,181,1622,58,145,347,550,2172,0.632508455,109.952123
AIR BESAR,110,1499,608,193,2300,40,94,279,413,2713,0.826306749,110.0506226
SIANTAN,80,1013,336,124,1473,97,150,306,553,2026,0.089710326,109.2693409
SEGEDONG,81,955,332,126,1413,110,164,316,590,2003,0.204672075,109.2488375
SUNGAI PINYUH,90,1380,397,150,1927,128,260,428,816,2743,0.293383119,109.1035199
ANJONGAN,91,486,176,77,739,33,35,118,186,925,0.358112587,109.1596433
MEMPAWAH HILIR,100,885,308,130,1323,70,109,247,426,1749,0.435426456,109.0257685
MEMPAWAH TIMUR,101,708,214,74,996,99,156,216,471,1467,0.350412392,109.0076699
SUNGAI KUNYIT,110,995,289,110,1394,73,128,277,478,1872,0.512499858,108.9838923
TOHO,120,627,251,123,1001,126,109,230,465,1466,0.41325825,109.2244781
SADANIANG,121,731,280,140,1151,54,112,228,394,1545,0.57032378,109.1692877
TOBA,10,210,78,87,375,55,46,36,137,512,-0.23985511,110.0544936
MELIAU,20,656,236,91,983,147,158,240,545,1528,-0.265836261,110.3354255
KAPUAS,60,466,165,67,698,92,118,145,355,1053,0.003391871,110.5550453
MUKOK,70,119,45,36,200,74,35,35,144,344,0.16689337,110.7997034
JANGKANG,120,735,365,223,1323,209,177,272,658,1981,0.511300135,110.8337876
BONTI,130,544,207,92,843,52,52,138,242,1085,0.46140489,110.5898871
PARINDU,140,114,53,33,200,30,14,24,68,268,0.21783916,110.4281042
TAYAN HILIR,150,459,156,93,708,53,82,116,251,959,0.024249568,110.0904065
BALAI,160,378,98,34,510,46,56,124,226,736,0.159662746,110.1386295
TAYAN HULU,170,262,91,43,396,61,57,79,197,593,0.348099702,110.2633987
KEMBAYAN,180,227,83,37,347,64,69,87,220,567,0.549163682,110.3824957
BEDUWAI,190,243,111,50,404,41,40,73,154,558,0.736663703,110.3047908
NOYAN,200,367,133,62,562,179,86,96,361,923,0.703352331,110.6033695
SEKAYAM,210,346,115,74,535,67,51,81,199,734,0.823662701,110.5584103
ENTIKONG,220,184,55,16,255,43,38,59,140,395,1.000590509,110.2522504
KENDAWANGAN,10,1124,305,132,1561,262,254,384,900,2461,-2.626103211,110.5270463
MANIS MATA,20,1094,139,44,1277,129,327,267,723,2000,-2.454492918,111.0065991
MARAU,30,460,144,96,700,142,71,92,305,1005,-2.124567277,110.6589379
SINGKUP,31,426,170,123,719,31,29,44,104,823,-2.329889287,110.5986735
AIR UPAS,32,555,197,92,844,82,82,156,320,1164,-2.378396699,110.7772082
JELAI HULU,40,875,209,74,1158,193,219,264,676,1834,-1.939970081,110.8868681
TUMBANG TITI,50,950,241,93,1284,148,145,263,556,1840,-1.820863627,110.6714972
PEMAHAN,51,122,38,16,176,13,20,36,69,245,-1.70696252,110.5269816
SUNGAI MELAYU RAYAK,52,458,139,86,683,29,55,115,199,882,-1.881870364,110.4324625
MATAN HILIR SELATAN,60,1131,327,116,1574,110,232,412,754,2328,-2.047558003,110.2404043
BENUA KAYONG,61,1054,385,121,1560,71,174,280,525,2085,-1.773282632,110.2128202
MATAN HILIR UTARA,70,1132,376,164,1672,109,168,296,573,2245,-1.489896562,110.1756367
DELTA PAWAN,71,1599,502,228,2329,57,148,324,529,2858,-1.812251439,109.9584907
MUARA PAWAN,72,878,283,104,1265,62,83,232,377,1642,-1.730698412,110.1045238
NANGA TAYAP,90,1172,253,103,1528,130,258,393,781,2309,-1.481645972,110.5672233
SANDAI,100,631,189,75,895,48,82,165,295,1190,-1.182806145,110.6137347
HULU SUNGAI,101,867,224,88,1179,101,142,205,448,1627,-0.999134329,110.9730769
SUNGAI LAUR,110,978,304,129,1411,51,104,189,344,1755,-0.824330162,110.524394
SIMPANG HULU,120,909,197,74,1180,314,251,290,855,2035,-0.545991327,110.237425
SIMPANG DUA,121,462,141,67,670,101,51,73,225,895,-0.759272025,110.2478543
SERAWAI,60,2310,782,255,3347,168,209,568,945,4292,-0.386947274,112.5891981
AMBALAU,70,1600,383,112,2095,203,306,458,967,3062,-0.076801327,112.9908216
KAYAN HULU,80,955,267,111,1333,463,249,354,1066,2399,-0.069746812,112.2530602
SEPAUK,110,1807,605,324,2736,241,192,356,789,3525,-0.181373562,111.1956374
TEMPUNAK,120,670,172,34,876,73,116,169,358,1234,-0.151166237,111.3382815
SUNGAI TEBELIAN,130,603,199,117,919,43,49,98,190,1109,-0.138853527,111.4791825
SINTANG,140,519,186,89,794,27,28,94,149,943,0.068206262,111.5056283
DEDAI,150,935,343,91,1369,52,76,198,326,1695,-0.03091868,111.7090949
KAYAN HILIR,160,1287,466,287,2040,375,184,309,868,2908,-0.024258774,111.9391004
KELAM PERMAI,170,1037,308,142,1487,52,92,206,350,1837,0.163279279,111.7303737
BINJAI HULU,180,554,195,71,820,86,59,110,255,1075,0.20711835,111.4929676
KETUNGAU HILIR,190,1293,509,394,2196,212,114,162,488,2684,0.437941465,111.4966886
KETUNGAU TENGAH,200,2647,851,394,3892,371,317,572,1260,5152,0.757496678,111.4600064
KETUNGAU HULU,210,1786,453,127,2366,143,179,414,736,3102,0.878998494,111.0864676
SILAT HILIR,10,487,132,45,664,87,107,146,340,1004,0.344111154,111.815946
SILAT HULU,20,264,91,100,455,200,69,89,358,813,0.204948212,112.2244327
HULU GURUNG,30,261,88,43,392,7,27,56,90,482,0.377209004,112.2712902
BUNUT HULU,40,316,110,36,462,44,85,158,287,749,0.359278979,112.7416404
MENTEBAH,50,561,214,107,882,97,56,109,262,1144,0.460307737,112.9246369
BIKA,60,220,76,19,315,32,32,41,105,420,0.783970808,112.8183678
KALIS,70,776,259,103,1138,27,83,181,291,1429,0.505889762,113.1970084
PUTUSSIBAU SELATAN,80,248,80,24,352,20,21,60,101,453,0.815702,112.9328299
HULU KAPUAS,81,330,94,36,460,26,53,74,153,613,0.923586986,113.6552787
EMBALOH HILIR,90,319,97,42,458,67,57,112,236,694,0.923627067,112.6260871
BUNUT HILIR,100,366,108,32,506,56,63,123,242,748,0.741738344,112.5547923
BOYAN TANJUNG,110,349,109,29,487,13,50,92,155,642,0.432026357,112.5225677
PENGKADAN,120,155,51,19,225,29,31,44,104,329,0.485291701,112.3606298
JONGKONG,130,476,167,73,716,24,66,145,235,951,0.662447375,112.348231
SELIMBAU,140,391,125,52,568,31,44,91,166,734,0.591997602,112.1642904
DANAU SENTARUM,141,323,78,22,423,12,58,92,162,585,0.830411229,112.120157
SUHAID,150,212,85,35,332,14,26,48,88,420,0.662231881,112.0101754
SEBERUANG,160,382,133,41,556,29,53,79,161,717,0.377741191,112.0520748
SEMITAU,170,184,54,9,247,17,22,44,83,330,0.596003556,111.8592955
EMPANANG,180,119,39,10,168,3,11,31,45,213,0.829621582,111.7874901
PURING KENCANA,190,81,4,2,87,40,64,51,155,242,0.963289022,111.6756729
BADAU,200,117,24,10,151,56,32,54,142,293,0.959937987,111.9457035
BATANG LUPAR,210,138,60,41,239,40,26,48,114,353,1.028088763,112.2700497
EMBALOH HULU,220,330,135,59,524,37,21,69,127,651,1.341565178,112.5874304
PUTUSSIBAU UTARA,230,667,164,52,883,82,111,190,383,1266,1.127250566,113.1050371
NANGA MAHAP,10,1625,560,229,2414,289,240,331,860,3274,-0.484348652,110.7312007
NANGA TAMAN,20,823,340,186,1349,218,114,165,497,1846,-0.320864397,110.8151046
SEKADAU HULU,30,1462,595,312,2369,175,138,247,560,2929,-0.15500946,110.9305947
SEKADAU HILIR,40,1967,751,338,3056,167,183,408,758,3814,0.040521336,110.938637
BELITANG HILIR,50,209,84,59,352,34,25,39,98,450,0.223888054,111.0639129
BELITANG,60,342,108,48,498,29,31,74,134,632,0.242751543,111.1987912
BELITANG HULU,70,1087,508,195,1790,123,71,252,446,2236,0.516131722,111.1269022
SOKAN,10,987,293,161,1441,178,148,215,541,1982,-1.069756714,111.3924593
TANAH PINOH,20,661,235,120,1016,42,63,140,245,1261,-0.80167857,111.5580064
TANAH PINOH BARAT,21,714,141,38,893,70,132,209,411,1304,-0.763509254,111.3770839
SAYAN,30,400,122,64,586,41,62,93,196,782,-0.754275643,111.7139874
BELIMBING,40,1105,308,112,1525,52,171,258,481,2006,-0.428354578,111.4578652
BELIMBING HULU,41,374,151,69,594,67,48,98,213,807,-0.478720731,111.5344559
NANGA PINOH,50,524,146,67,737,72,88,133,293,1030,-0.357994179,111.7697344
PINOH SELATAN,51,363,99,37,499,39,69,96,204,703,-0.589205413,111.8618426
PINOH UTARA,52,531,247,181,959,176,94,117,387,1346,-0.267957732,111.8536596
ELLA HILIR,60,997,363,212,1572,85,135,232,452,2024,-0.539178979,112.0531454
MENUKUNG,70,1246,368,153,1767,156,133,237,526,2293,-0.466481398,112.2940845
PULAU MAYA KARIMATA,10,1143,377,178,1698,202,173,312,687,2385,-1.218038881,109.446769
SUKADANA,20,703,198,77,978,54,107,190,351,1329,-1.246649803,110.06432
SIMPANG HILIR,30,1222,373,194,1789,173,204,383,760,2549,-1.044344735,110.1630989
TELUK BATANG,40,1113,338,166,1617,132,196,378,706,2323,-0.96102196,109.8266328
SEPONTI,50,462,174,107,743,74,50,124,248,991,-0.838632196,109.9276177
BATU AMPAR,10,2686,1024,422,4132,261,386,788,1435,5567,-0.744109048,109.6114735
TERENTANG,20,856,254,107,1217,33,108,168,309,1526,-0.403190389,109.7421902
KUBU,30,1771,676,283,2730,206,317,539,1062,3792,-0.484929031,109.3884288
TELOK PA'KEDAI,40,1176,343,208,1727,176,224,321,721,2448,-0.361439347,109.1763784
SUNGAI KAKAP,50,3522,1443,666,5631,554,576,1075,2205,7836,-0.125628796,109.2084898
RASAU JAYA,60,981,351,179,1511,52,105,258,415,1926,-0.247111328,109.3451275
SUNGAI RAYA,70,6638,2629,1215,10482,1143,1236,2360,4739,15221,-0.224096377,109.6295796
SUNGAI AMBAWANG,80,3684,1593,889,6166,231,408,1006,1645,7811,-0.051293061,109.6499084
KUALA MANDOR-B,90,1363,533,214,2110,188,167,433,788,2898,0.120450609,109.4456482
PONTIANAK SELATAN,10,503,195,86,784,29,53,111,193,977,-0.054787349,109.3289606
PONTIANAK TENGGARA,11,502,208,115,825,23,33,105,161,986,-0.070387198,109.3465866
PONTIANAK TIMUR,20,3028,1221,668,4917,127,223,628,978,5895,-0.037275081,109.366594
PONTIANAK BARAT,30,2597,1023,463,4083,127,221,572,920,5003,-0.017821395,109.2987515
PONTIANAK KOTA,31,1213,533,247,1993,49,85,257,391,2384,-0.036984878,109.3130107
PONTIANAK UTARA,40,3379,1376,605,5360,232,437,901,1570,6930,0.008624166,109.3379427
SINGKAWANG SELATAN,10,2095,631,194,2920,155,336,536,1027,3947,0.832527904,108.9754715
SINGKAWANG TIMUR,20,1525,424,174,2123,84,182,352,618,2741,0.927690562,109.0903369
SINGKAWANG UTARA,30,1079,276,102,1457,54,136,234,424,1881,0.962607145,109.0131664
SINGKAWANG BARAT,40,742,203,71,1016,46,109,198,353,1369,0.903165324,108.976376
SINGKAWANG TENGAH,50,1439,368,160,1967,100,194,342,636,2603,0.915100478,109.0033137
KOTAWARINGIN LAMA,40,418,145,76,639,26,44,86,156,795,-2.471257196,111.4168405
ARUT SELATAN,50,1167,493,241,1901,126,101,267,494,2395,-2.532699711,111.6071434
KUMAI,60,1443,576,282,2301,115,169,379,663,2964,-2.935205848,111.8370172
PANGKALAN BANTENG,61,449,183,87,719,41,40,106,187,906,-2.453817086,111.9289852
PANGKALAN LADA,62,573,268,136,977,100,63,174,337,1314,-2.514100747,111.7759211
ARUT UTARA,70,151,30,17,198,13,25,48,86,284,-2.01932601,111.8978933
MENTAYA HILIR SELATAN,20,1038,414,134,1586,32,89,332,453,2039,-2.872502416,112.9214889
TELUK SAMPIT,21,562,157,58,777,67,144,186,397,1174,-3.06797486,112.9140122
PULAU HANAUT,50,1349,341,141,1831,132,303,462,897,2728,-2.863462753,113.0532336
MENTAWA BARU/KETAPANG,60,1242,362,190,1794,180,231,387,798,2592,-2.603177231,112.8823902
SERANAU,61,798,254,96,1148,39,114,251,404,1552,-2.533347169,113.0836491
MENTAYA HILIR UTARA,70,817,241,123,1181,31,93,231,355,1536,-2.669776683,112.7259555
KOTA BESI,110,1091,350,137,1578,51,131,264,446,2024,-2.339969601,112.8250486
TELAWANG,111,331,101,40,472,29,24,68,121,593,-2.356693665,112.5959011
BAAMANG,120,1383,456,206,2045,56,116,287,459,2504,-2.505491316,112.7790941
CEMPAGA,190,1081,319,143,1543,70,138,250,458,2001,-2.251768883,113.0227973
CEMPAGA HULU,191,729,182,70,981,87,124,175,386,1367,-1.968829269,113.0509083
PARENGGEAN,200,1400,426,141,1967,70,143,351,564,2531,-1.852250467,112.7875261
MENTAYA HULU,210,898,345,169,1412,83,95,204,382,1794,-2.061662983,112.5228901
BUKIT SANTUAI,211,657,179,72,908,54,99,208,361,1269,-1.720889911,112.3098943
ANTANG KALANG,230,1696,506,181,2383,134,188,481,803,3186,-1.463569189,112.5150055
KAPUAS KUALA,20,761,169,58,988,108,148,223,479,1467,-3.339376609,114.3069126
TAMBAN CATUR,21,330,106,42,478,27,37,93,157,635,-3.218974721,114.3759196
KAPUAS TIMUR,30,626,185,45,856,37,84,168,289,1145,-3.08336635,114.4577551
SELAT,40,324,84,31,439,36,58,95,189,628,-2.993295622,114.3862682
BATAGUH,41,1321,322,91,1734,159,259,417,835,2569,-3.192575887,114.2786352
BASARANG,70,358,100,32,490,24,57,105,186,676,-2.967029256,114.3054602
KAPUAS HILIR,80,210,53,29,292,20,29,57,106,398,-2.996363743,114.454294
PULAU PETAK,90,626,185,63,874,31,100,143,274,1148,-2.911750201,114.4944856
KAPUAS MURUNG,100,737,236,97,1070,67,125,227,419,1489,-2.746749892,114.6259056
DADAHUP,101,376,141,67,584,24,49,99,172,756,-2.623498194,114.6352513
KAPUAS BARAT,110,373,112,36,521,44,66,141,251,772,-2.803943858,114.3925543
MANTANGAI,150,970,202,57,1229,42,210,279,531,1760,-1.960717584,114.3033715
TIMPAH,160,200,46,11,257,14,18,51,83,340,-1.577408678,114.5493012
KAPUAS TENGAH,170,153,44,8,205,29,44,60,133,338,-1.187298301,114.3765723
PASAK TALAWANG,171,118,25,7,150,5,13,28,46,196,-1.05834379,114.1794519
KAPUAS HULU,180,259,52,12,323,19,40,62,121,444,-0.816656358,113.8842257
MANDAU TALAWANG,181,112,19,5,136,6,17,54,77,213,-0.654148603,113.9680765
JENAMAS,10,108,35,16,159,7,14,36,57,216,-2.437685851,114.8641786
DUSUN HILIR,20,324,104,46,474,94,77,130,301,775,-2.264330939,114.7609972
KARAU KUALA,30,496,140,49,685,14,39,105,158,843,-1.91711431,114.8004468
DUSUN SELATAN,40,634,223,113,970,34,47,81,162,1132,-1.679839379,114.8181316
DUSUN UTARA,50,478,153,87,718,11,18,64,93,811,-1.433102788,114.9204827
GUNUNG BINTANG AWAI,60,282,90,30,402,16,31,62,109,511,-1.495377771,115.2352256
MONTALAT,10,236,75,31,342,9,23,42,74,416,-1.243948145,114.8276697
GUNUNG TIMANG,20,425,146,40,611,7,28,102,137,748,-1.239118613,115.1967231
GUNUNG PUREI,30,65,30,11,106,1,4,17,22,128,-1.192491586,115.6108621
TEWEH TIMUR,40,413,107,57,577,48,49,114,211,788,-1.020846082,115.3624864
TEWEH TENGAH,50,1248,431,174,1853,98,107,257,462,2315,-1.003026864,114.8040155
LAHEI,60,280,69,16,365,30,46,83,159,524,-0.60129482,115.1312354
JELAI,10,159,37,24,220,9,13,36,58,278,-2.948196266,110.898064
PANTAI LUNCI,11,286,92,42,420,8,14,53,75,495,-2.889317054,111.1618055
SUKAMARA,20,342,99,63,504,11,21,64,96,600,-2.604166931,111.2312322
BALAI RIAM,30,171,40,43,254,18,19,27,64,318,-2.344840289,111.1695162
PERMATA KECUBUNG,31,201,51,20,272,21,36,57,114,386,-2.19925851,111.2094935
BULIK,10,246,91,48,385,13,25,41,79,464,-2.114295175,111.4239122
SEMATU JAYA,11,114,48,20,182,5,4,33,42,224,-2.235369602,111.5562758
MENTHOBI RAYA,12,188,68,25,281,20,25,33,78,359,-1.996683062,111.6946089
BULIK TIMUR,13,265,83,26,374,22,29,55,106,480,-1.725726166,111.6387832
LAMANDAU,20,199,52,26,277,35,31,45,111,388,-1.913654384,111.1779753
BELANTIKAN RAYA,21,176,46,39,261,39,32,36,107,368,-1.59915476,111.4117678
DELANG,30,391,119,48,558,24,47,89,160,718,-1.643900692,111.0293442
BATANGKAWA,31,60,11,3,74,34,20,18,72,146,-1.635139322,111.2146892
SERUYAN HILIR,10,875,399,309,1583,57,29,94,180,1763,-3.097439886,112.4189373
DANAU SEMBULUH,20,511,213,143,867,25,22,65,112,979,-2.669822983,112.2825545
HANAU,30,202,105,61,368,16,16,33,65,433,-2.470831356,112.1841815
SERUYAN TENGAH,40,359,224,142,725,23,20,61,104,829,-1.956659925,112.111753
SERUYAN HULU,50,376,184,67,627,16,12,62,90,717,-1.195306739,111.8531357
KATINGAN KUALA,10,429,175,79,683,18,33,120,171,854,-3.074429254,113.4548258
MENDAWAI,20,125,53,15,193,29,23,59,111,304,-2.712762552,113.4060528
KAMIPANG,30,112,47,5,164,6,14,35,55,219,-2.328676469,113.413159
TASIK PAYAWAN,40,99,26,18,143,5,20,31,56,199,-2.050951318,113.4438448
KATINGAN HILIR,50,266,85,32,383,13,27,59,99,482,-1.891605164,113.3843319
TEWANG SANGALANG GARING,60,246,94,49,389,6,11,38,55,444,-1.748411282,113.3379045
PULAU MALAN,70,341,150,45,536,7,11,78,96,632,-1.62977697,113.2112802
KATINGAN TENGAH,80,271,114,52,437,15,51,79,145,582,-1.436918557,112.9827082
SANAMAN MANTIKEI,90,102,43,17,162,2,8,32,42,204,-1.203038014,113.0907187
PETAK MALAI,91,78,45,24,147,10,5,15,30,177,-0.782637333,112.9451893
MARIKIT,100,288,138,17,443,33,42,113,188,631,-0.951187813,112.6294686
KATINGAN HULU,110,215,77,16,308,3,32,36,71,379,-1.059774374,112.3496484
BUKIT RAYA,111,106,46,10,162,7,14,23,44,206,-0.923332512,112.2166504
KAHAYAN KUALA,10,949,328,133,1410,128,181,248,557,1967,-3.280985312,113.9641996
SEBANGAU KUALA,11,394,193,108,695,36,32,75,143,838,-2.835131777,113.8376211
PANDIH BATU,20,793,292,98,1183,70,86,198,354,1537,-3.078214438,114.1112164
MALIKU,30,1196,391,204,1791,26,83,192,301,2092,-2.954126303,114.162189
KAHAYAN HILIR,40,1092,401,177,1670,62,105,233,400,2070,-2.761409326,114.2028124
JABIREN RAYA,41,405,137,97,639,45,41,78,164,803,-2.447553742,114.1937386
KAHAYAN TENGAH,50,317,139,68,524,16,21,73,110,634,-2.01054121,113.9779062
BANAMATINGANG,60,134,52,39,225,46,18,32,96,321,-1.712510748,113.9024922
MANUHING,10,172,36,11,219,12,31,48,91,310,-1.474062545,113.4573937
MANUHING RAYA,11,198,71,11,280,8,27,63,98,378,-1.169229207,113.287686
RUNGAN,20,254,81,28,363,9,31,66,106,469,-1.355561896,113.5982706
RUNGAN HULU,21,199,80,6,285,1,14,49,64,349,-1.088419644,113.5063657
SEPANG,30,148,63,33,244,10,13,35,58,302,-1.503916742,113.8709234
MIHING RAYA,31,162,65,24,251,6,13,33,52,303,-1.356334889,113.8863251
KURUN,40,366,145,80,591,7,25,74,106,697,-1.172250076,113.8662994
TEWAH,50,546,214,86,846,32,76,160,268,1114,-1.028241332,113.6993482
KAHAYAN HULU UTARA,60,278,100,58,436,11,24,64,99,535,-0.872293584,113.5328801
DAMANG BATU,61,167,43,7,217,3,9,29,41,258,-0.7169599,113.2839848
MIRI MANASA,62,188,54,14,256,7,10,33,50,306,-0.567583048,113.5786859
BENUA LIMA,10,62,29,13,104,2,2,6,10,114,-2.251995921,115.1157939
DUSUN TIMUR,20,251,88,38,377,7,13,40,60,437,-2.107775066,115.1726551
AWANG,30,121,26,16,163,5,6,17,28,191,-1.958255925,115.2597471
PATANGKEP TUTUI,40,109,44,13,166,1,6,26,33,199,-1.992085482,115.3484164
DUSUN TENGAH,50,262,63,23,348,24,61,69,154,502,-1.766116447,115.2358357
PEMATANG KARAU,60,561,171,105,837,23,41,113,177,1014,-1.835300608,115.0278829
PAJU EPAT,70,75,36,10,121,1,11,19,31,152,-2.124163055,115.0132667
RAREN BATUAH,80,188,55,29,272,7,19,24,50,322,-1.696588162,115.1782663
PAKU,90,136,59,29,224,13,22,34,69,293,-1.898996518,115.1939389
KARUSEN JANANG,100,118,34,13,165,4,9,21,34,199,-1.955079245,115.080836
PERMATA INTAN,10,1232,318,10,1560,7,67,110,184,1744,-0.730718682,114.2625933
SUNGAI BABUAT,11,140,29,20,189,1,9,16,26,215,-0.524706723,114.358721
MURUNG,20,1097,265,125,1487,23,60,149,232,1719,-0.729577712,114.5471672
LAUNG TUHUP,30,845,210,59,1114,12,40,132,184,1298,-0.395309309,114.7286117
BARITO TUHUP RAYA,31,119,21,6,146,3,8,11,22,168,-0.357267485,114.9122138
TANAH SIANG,40,737,174,80,991,10,44,118,172,1163,-0.351082384,114.528092
TANAH SIANG SELATAN,41,121,42,20,183,5,7,21,33,216,-0.656193231,114.4486838
SUMBER BARITO,50,453,106,44,603,29,38,93,160,763,-0.404560747,114.1563537
SERIBU RIAM,51,240,60,10,310,10,22,47,79,389,0.08774936,113.7797732
UUT MURUNG,52,192,30,5,227,6,23,34,63,290,0.279782718,114.5499426
PAHANDUT,10,1503,421,213,2137,117,170,300,587,2724,-2.213200022,113.952717
SEBANGAU,11,474,149,76,699,17,36,71,124,823,-2.307933308,113.9158564
JEKAN RAYA,12,1023,351,172,1546,53,70,188,311,1857,-2.196324034,113.8124294
BUKIT BATU,20,470,159,83,712,44,30,86,160,872,-2.006162004,113.7458589
RAKUMPIT,21,119,57,19,195,14,8,29,51,246,-1.764369147,113.659399
PANYIPATAN,10,1091,372,182,1645,36,118,250,404,2049,-4.0513268,114.7069434
TAKISUNG,20,662,198,81,941,39,97,213,349,1290,-3.857085734,114.6468142
KURAU,30,578,205,85,868,38,94,164,296,1164,-3.631468196,114.6491346
BUMI MAKMUR,31,579,180,93,852,39,68,149,256,1108,-3.550590103,114.6289114
BATI - BATI,40,996,351,140,1487,70,154,298,522,2009,-3.572401716,114.7932214
TAMBANG ULANG,50,587,155,48,790,49,100,187,336,1126,-3.654145624,114.7659921
PELAIHARI,60,1145,438,182,1765,66,142,326,534,2299,-3.785438678,114.7486046
BAJUIN,61,370,96,40,506,28,77,146,251,757,-3.709963591,114.8846857
BATU AMPAR,70,381,123,51,555,15,50,82,147,702,-3.837293031,114.9216705
JORONG,80,726,278,65,1069,53,116,242,411,1480,-3.935814196,114.9738649
KINTAP,90,801,265,102,1168,80,106,224,410,1578,-3.768250074,115.2175548
PULAU SEMBILAN,10,230,56,20,306,48,34,60,142,448,-4.620588757,115.7392556
PULAU LAUT BARAT,20,847,291,125,1263,86,103,207,396,1659,-3.895487822,116.1067531
PULAU LAUT SELATAN,30,704,220,125,1049,66,58,104,228,1277,-3.814977377,116.2316896
PULAU LAUT KEPULAUAN,31,549,199,98,846,57,56,109,222,1068,-3.963601212,116.1703927
PULAU LAUT TIMUR,40,285,98,34,417,54,44,89,187,604,-3.547621128,116.2282869
PULAU SEBUKU,50,75,40,25,140,23,10,24,57,197,-3.509308849,116.3800425
PULAU LAUT UTARA,60,1354,373,203,1930,166,196,328,690,2620,-3.290143189,116.2071015
PULAU LAUT TENGAH,61,271,89,29,389,30,41,61,132,521,-3.558159704,116.1000138
KELUMPANG SELATAN,120,163,52,22,237,17,27,44,88,325,-3.079123918,116.1289255
KELUMPANG HILIR,121,149,66,30,245,19,9,33,61,306,-3.194448683,116.0578176
KELUMPANG HULU,130,200,74,37,311,40,47,48,135,446,-2.924461878,115.9535878
HAMPANG,140,180,40,11,231,199,84,100,383,614,-2.907011304,115.7278257
SUNGAI DURIAN,150,92,34,16,142,58,32,32,122,264,-2.557396547,116.0196949
KELUMPANG TENGAH,160,163,47,20,230,6,21,37,64,294,-2.871408418,116.2082349
KELUMPANG BARAT,161,70,18,5,93,9,17,18,44,137,-2.732038302,116.097348
KELUMPANG UTARA,170,130,47,32,209,14,11,25,50,259,-2.849339869,116.303607
PAMUKAN SELATAN,180,90,22,10,122,4,17,15,36,158,-2.552351069,116.4217967
SAMPANAHAN,190,236,83,25,344,48,46,63,157,501,-2.638579486,116.2602499
PAMUKAN UTARA,200,98,42,25,165,14,23,22,59,224,-2.40756666,116.2759812
PAMUKAN BARAT,210,99,47,17,163,37,23,41,101,264,-2.390431251,115.9855595
ALUH - ALUH,10,1655,508,225,2388,88,223,481,792,3180,-3.448230017,114.5608271
BERUNTUNG BARU,11,616,254,120,990,25,50,154,229,1219,-3.495605016,114.6514854
GAMBUT,20,490,175,91,756,28,72,151,251,1007,-3.421141235,114.6801129
KERTAK HANYAR,30,657,221,101,979,26,83,210,319,1298,-3.368973914,114.662394
TATAH MAKMUR,31,378,158,77,613,13,48,95,156,769,-3.397641419,114.6162251
SUNGAI TABUK,40,1229,448,230,1907,162,199,418,779,2686,-3.296430179,114.714188
MARTAPURA,50,1039,369,184,1592,255,273,424,952,2544,-3.400477043,114.8693203
MARTAPURA TIMUR,51,474,115,42,631,56,152,235,443,1074,-3.359033509,114.8687898
MARTAPURA BARAT,52,683,186,80,949,120,200,374,694,1643,-3.326669311,114.8095852
ASTAMBUL,60,886,297,125,1308,82,162,305,549,1857,-3.319180003,114.9274502
KARANG INTAN,70,511,156,80,747,59,123,210,392,1139,-3.488672873,114.9812489
ARANIO,80,275,93,19,387,22,62,123,207,594,-3.517482492,115.1707111
SUNGAI PINANG,90,277,79,20,376,58,94,108,260,636,-3.246806915,115.3186373
PARAMASAN,91,198,52,17,267,87,46,71,204,471,-3.014469163,115.4255257
PENGARON,100,278,95,22,395,52,95,117,264,659,-3.308021522,115.1688493
SAMBUNG MAKMUR,101,221,96,61,378,107,38,59,204,582,-3.226137915,115.1468504
MATARAMAN,110,203,52,17,272,51,60,104,215,487,-3.334622263,115.0342628
SIMPANG EMPAT,120,496,126,30,652,75,157,219,451,1103,-3.181467293,114.943734
TELAGA BAUNTUNG,121,58,11,2,71,7,23,25,55,126,-3.093370138,115.2319917
TABUNGANEN,10,767,197,79,1043,83,116,197,396,1439,-3.440636503,114.4390023
TAMBAN,20,1193,386,146,1725,126,171,342,639,2364,-3.331928529,114.4663138
MEKAR SARI,30,824,311,104,1239,31,81,202,314,1553,-3.275118358,114.4491874
ANJIR PASAR,40,387,140,53,580,12,29,93,134,714,-3.13930377,114.5046206
ANJIR MUARA,50,832,285,120,1237,32,89,206,327,1564,-3.186367951,114.5321222
ALALAK,60,1383,438,198,2019,85,196,380,661,2680,-3.231682146,114.5924987
MANDASTANA,70,626,255,141,1022,10,56,167,233,1255,-3.21323169,114.667282
JEJANGKIT,71,427,175,64,666,22,42,114,178,844,-3.177631756,114.764402
BELAWANG,80,472,157,33,662,17,60,115,192,854,-3.115871673,114.6153045
WANARAYA,90,316,105,42,463,27,33,73,133,596,-3.01403746,114.5729089
BARAMBAI,100,489,158,66,713,36,66,132,234,947,-2.989659309,114.6561365
RANTAU BADAUH,110,214,76,26,316,9,27,60,96,412,-3.110647327,114.7135161
CERBON,120,182,47,16,245,12,34,43,89,334,-3.045688861,114.7775136
BAKUMPAI,130,385,123,72,580,67,81,136,284,864,-2.871286621,114.7883902
MARABAHAN,140,368,162,79,609,15,40,106,161,770,-2.907952629,114.7144421
TABUKAN,150,430,129,61,620,28,50,93,171,791,-2.838265043,114.6435035
KURIPAN,160,283,76,41,400,14,34,85,133,533,-2.688260554,114.7881187
BINUANG,10,484,101,42,627,35,106,143,284,911,-3.121430355,115.0670118
HATUNGUN,11,207,38,18,263,44,48,68,160,423,-3.157987213,115.1780053
TAPIN SELATAN,20,298,75,22,395,26,75,115,216,611,-3.034215515,115.0896865
SALAM BABARIS,21,134,36,14,184,8,19,59,86,270,-3.066610346,115.1748996
TAPIN TENGAH,30,464,94,52,610,79,154,208,441,1051,-2.990026547,114.9927764
BUNGUR,40,264,48,25,337,32,59,76,167,504,-2.994868993,115.2128882
PIANI,50,302,63,25,390,40,51,109,200,590,-2.938398019,115.3831287
LOKPAIKAT,60,104,32,12,148,15,29,49,93,241,-2.912684079,115.2133165
TAPIN UTARA,70,277,68,42,387,12,41,67,120,507,-2.925849754,115.1560347
BAKARANGAN,80,306,65,18,389,39,73,111,223,612,-2.88021327,115.1149943
CANDI LARAS SELATAN,90,357,174,148,679,40,39,69,148,827,-2.864055986,114.9894776
CANDI LARAS UTARA,100,642,164,59,865,65,137,243,445,1310,-2.781707215,114.881324
PADANG BATUNG,10,481,134,52,667,38,58,92,188,855,-2.851208746,115.3216186
LOKSADO,20,567,183,65,815,94,85,158,337,1152,-2.806251848,115.4812511
TELAGA LANGSAT,30,430,150,58,638,13,51,108,172,810,-2.748767233,115.3565753
ANGKINANG,40,625,191,93,909,38,97,164,299,1208,-2.718526645,115.272809
KANDANGAN,50,1397,460,192,2049,56,132,276,464,2513,-2.726137618,115.2228014
SUNGAI RAYA,60,410,87,34,531,29,68,99,196,727,-2.84754347,115.2341191
SIMPUR,70,559,189,99,847,28,63,132,223,1070,-2.768009212,115.1898347
KALUMPANG,80,362,128,28,518,16,47,98,161,679,-2.797995026,115.1270324
DAHA SELATAN,90,2046,667,251,2964,196,441,727,1364,4328,-2.658179628,115.0535966
DAHA BARAT,91,294,85,45,424,26,61,106,193,617,-2.674622854,114.9967935
DAHA UTARA,100,1161,322,129,1612,94,251,426,771,2383,-2.564563013,115.0462034
HARUYAN,10,724,202,103,1029,66,132,176,374,1403,-2.697955259,115.3786108
BATU BENAWA,20,522,173,97,792,27,61,97,185,977,-2.6172038,115.4368573
HANTAKAN,30,668,143,48,859,107,166,243,516,1375,-2.682228174,115.4925231
BATANG ALAI SELATAN,40,823,323,138,1284,24,65,179,268,1552,-2.559919726,115.4604025
BATANG ALAI TIMUR,41,402,135,61,598,88,60,92,240,838,-2.594822984,115.67985
BARABAI,50,872,299,171,1342,29,108,217,354,1696,-2.579465921,115.3881458
LABUAN AMAS SELATAN,60,862,253,109,1224,58,149,244,451,1675,-2.651140047,115.3091725
LABUAN AMAS UTARA,70,723,191,72,986,64,117,188,369,1355,-2.598128483,115.2373854
PANDAWAN,80,1322,494,215,2031,32,105,291,428,2459,-2.551553292,115.3226509
BATANG ALAI UTARA,90,764,222,75,1061,27,126,228,381,1442,-2.49677854,115.4045701
LIMPASU,91,317,103,50,470,27,78,86,191,661,-2.492060914,115.4848826
DANAU PANGGANG,10,960,363,158,1481,33,139,356,528,2009,-2.44393391,115.0919997
PAMINGGIR,11,481,165,88,734,27,61,129,217,951,-2.443408404,114.9930519
BABIRIK,20,1050,335,150,1535,82,218,386,686,2221,-2.513532304,115.1223047
SUNGAI PANDAN,30,1047,344,151,1542,55,166,304,525,2067,-2.499867518,115.1990854
SUNGAI TABUKAN,31,699,188,78,965,56,156,279,491,1456,-2.44503773,115.1800622
AMUNTAI SELATAN,40,998,332,216,1546,83,164,302,549,2095,-2.369130128,115.1593218
AMUNTAI TENGAH,50,921,284,121,1326,65,160,295,520,1846,-2.478935654,115.2644989
BANJANG,60,887,257,161,1305,75,166,255,496,1801,-2.445957363,115.3326742
AMUNTAI UTARA,70,625,205,89,919,16,99,227,342,1261,-2.375669715,115.2935952
HAUR GADING,71,667,241,124,1032,38,80,168,286,1318,-2.371393868,115.2334772
BANUA LAWAS,10,1299,504,327,2130,85,182,359,626,2756,-2.295971189,115.2300272
PUGAAN,20,268,119,92,479,14,23,56,93,572,-2.31542726,115.3375097
KELUA,30,602,266,160,1028,19,57,151,227,1255,-2.2566004,115.2909518
MUARA HARUS,40,112,49,29,190,6,6,33,45,235,-2.259689471,115.3404566
TANTA,50,443,166,113,722,29,46,97,172,894,-2.242912541,115.4094052
TANJUNG,60,410,162,85,657,35,46,103,184,841,-2.098232622,115.3754466
MURUNG PUDAK,70,223,94,57,374,22,18,31,71,445,-2.153158998,115.4602913
HARUAI,80,293,97,67,457,49,49,66,164,621,-2.024744099,115.528904
BINTANG ARA,81,264,91,47,402,37,62,92,191,593,-1.843014023,115.3952917
UPAU,90,89,40,27,156,14,11,17,42,198,-2.078044128,115.622986
MUARA UYA,100,609,196,72,877,44,89,172,305,1182,-1.646905705,115.536668
JARO,110,452,170,69,691,20,48,123,191,882,-1.793824751,115.6619662
KUSAN HILIR,10,1063,308,116,1487,76,130,219,425,1912,-3.555828403,115.8952683
SUNGAI LOBAN,20,501,152,48,701,34,62,129,225,926,-3.653174566,115.7262602
SATUI,30,829,241,91,1161,68,83,213,364,1525,-3.661330113,115.4301923
ANGSANA,31,243,72,36,351,5,11,55,71,422,-3.689630599,115.6000651
KUSAN HULU,40,491,143,43,677,32,41,119,192,869,-3.389833378,115.5813332
KURANJI,41,364,152,114,630,33,20,33,86,716,-3.528877544,115.7007456
BATU LICIN,50,523,171,70,764,31,50,132,213,977,-3.460481618,115.949956
KARANG BINTANG,51,447,121,41,609,33,65,132,230,839,-3.375167458,115.8724791
SIMPANG EMPAT,52,724,197,66,987,59,85,166,310,1297,-3.29227677,115.973079
MANTEWE,53,520,203,134,857,51,55,112,218,1075,-3.199483287,115.6757372
LAMPIHONG,10,698,262,141,1101,28,106,186,320,1421,-2.363090647,115.3800729
BATU MANDI,20,525,132,61,718,30,76,112,218,936,-2.420892737,115.4589244
AWAYAN,30,500,166,78,744,26,64,118,208,952,-2.405660634,115.5537981
TEBING TINGGI,31,358,105,29,492,39,43,66,148,640,-2.460738514,115.6933816
PARINGIN,40,308,102,76,486,17,25,49,91,577,-2.277512541,115.5005709
PARINGIN SELATAN,41,228,83,45,356,11,29,68,108,464,-2.349092577,115.505659
JUAI,50,419,153,71,643,21,41,79,141,784,-2.274592575,115.604322
HALONG,60,488,131,59,678,102,106,166,374,1052,-2.226165277,115.740424
BANJARMASIN SELATAN,10,3958,1397,557,5912,205,461,1047,1713,7625,-3.348885303,114.5970163
BANJARMASIN TIMUR,20,1796,718,333,2847,121,173,371,665,3512,-3.326175449,114.6276892
BANJARMASIN BARAT,30,2735,1010,474,4219,120,204,568,892,5111,-3.321830783,114.5711362
BANJARMASIN TENGAH,31,1513,622,266,2401,90,142,315,547,2948,-3.319544674,114.5891517
BANJARMASIN UTARA,40,2238,739,314,3291,128,236,617,981,4272,-3.291370375,114.5929831
LANDASAN ULIN,10,925,394,217,1536,54,48,149,251,1787,-3.461229183,114.7875386
LIANG ANGGANG,11,736,236,121,1093,38,81,162,281,1374,-3.448945827,114.7349043
CEMPAKA,20,1266,376,206,1848,163,189,387,739,2587,-3.511924285,114.8729308
BANJAR BARU UTARA,31,310,162,79,551,27,26,65,118,669,-3.440108269,114.8781372
BANJAR BARU SELATAN,32,409,195,118,722,25,29,89,143,865,-3.455526399,114.8545171
BATU SOPANG,10,321,140,48,509,16,24,92,132,641,-1.743548247,115.9133399
MUARA SAMU,11,210,72,52,334,57,30,57,144,478,-2.088616333,115.8811968
BATU ENGAU,21,863,349,249,1461,184,98,221,503,1964,-2.193586713,116.1749067
TANJUNG HARAPAN,22,849,176,89,1114,86,172,242,500,1614,-2.234704426,116.4812864
PASIR BELENGKONG,30,1087,441,286,1814,90,103,263,456,2270,-1.969616185,116.2294159
TANAH GROGOT,40,932,353,217,1502,69,130,239,438,1940,-1.890016395,116.30041
KUARO,50,599,208,119,926,23,57,157,237,1163,-1.781851665,116.1659582
LONG IKIS,60,1166,491,329,1986,207,102,235,544,2530,-1.555499752,116.174726
MUARA KOMAM,70,430,133,68,631,75,62,123,260,891,-1.484451062,115.812418
LONG KALI,80,1558,632,366,2556,193,127,351,671,3227,-1.276694729,116.2011407
BONGAN,10,417,131,64,612,22,50,93,165,777,-0.838120765,116.2499402
JEMPANG,20,397,112,56,565,27,33,65,125,690,-0.559059724,116.108425
PENYINGGAHAN,30,178,61,12,251,2,18,36,56,307,-0.378330114,116.2360497
MUARA PAHU,40,465,149,103,717,19,32,87,138,855,-0.301838342,116.0272633
SILUQ NGURAI,41,349,121,82,552,7,0,7,14,566,-0.782421161,115.9279896
MUARA LAWA,50,199,77,27,303,10,7,25,42,345,-0.527436778,115.7548471
BENTIAN BESAR,51,291,97,44,432,13,22,71,106,538,-0.863167947,115.7318535
DAMAI,60,354,124,102,580,24,13,68,105,685,-0.623231557,115.5372628
NYUATAN,61,540,157,96,793,16,28,73,117,910,-0.317509124,115.412722
BARONG TONGKOK,70,597,278,145,1020,132,72,144,348,1368,-0.21324545,115.681035
LINGGANG BIGUNG,71,415,164,89,668,64,47,98,209,877,-0.096544058,115.4666551
MELAK,80,324,129,68,521,19,20,62,101,622,-0.292863799,115.8220157
SEKOLAQ DARAT,81,139,66,17,222,5,14,27,46,268,-0.280339907,115.7453509
MANOR BULATN,82,542,220,103,865,48,59,143,250,1115,-0.039336696,115.8808908
LONG IRAM,90,416,205,75,696,20,32,91,143,839,0.067976056,115.5989193
TERING,91,493,198,96,787,7,20,88,115,902,-0.035106386,115.6543528
LONG HUBUNG,100,486,211,109,806,27,24,86,137,943,0.219634181,115.4820239
LAHAM,101,222,85,50,357,7,12,32,51,408,0.157442317,115.0810044
LONG BAGUN,110,320,127,63,510,7,32,108,147,657,0.761888982,115.2735303
LONG PAHANGAI,120,149,54,25,228,7,7,30,44,272,0.957144759,114.6678117
LONG APARI,130,70,42,15,127,10,2,20,32,159,1.010601816,114.2293207
SEMBOJA,10,1706,783,440,2929,186,139,417,742,3671,-0.987863042,117.0318478
MUARA JAWA,20,660,221,111,992,37,68,171,276,1268,-0.814663968,117.2093136
SANGA-SANGA,30,222,86,50,358,22,40,80,142,500,-0.679006348,117.2393633
LOA JANAN,40,833,352,160,1345,210,164,297,671,2016,-0.73558421,117.0200335
LOA KULU,50,391,130,51,572,66,87,140,293,865,-0.648486445,116.7802143
MUARA MUNTAI,60,120,38,14,172,14,17,44,75,247,-0.543922678,116.4330835
MUARA WIS,70,362,116,64,542,16,43,74,133,675,-0.224516755,116.3024716
KOTABANGUN,80,966,398,224,1588,69,100,248,417,2005,-0.332992062,116.6275844
TENGGARONG,90,1110,490,226,1826,46,85,274,405,2231,-0.416082616,116.9537533
SEBULU,100,1009,418,236,1663,43,51,240,334,1997,-0.258208058,116.9549565
TENGGARONG SEBERANG,110,787,363,194,1344,74,76,191,341,1685,-0.285996127,117.1212778
ANGGANA,120,1792,638,266,2696,59,152,469,680,3376,-0.615610978,117.4300131
MUARA BADAK,130,1178,473,243,1894,78,118,313,509,2403,-0.350639144,117.3814496
MARANG KAYU,140,1295,575,329,2199,117,81,292,490,2689,-0.071970797,117.2954754
MUARA KAMAN,150,1741,538,260,2539,145,261,473,879,3418,0.075905965,116.8957294
KENOHAN,160,381,96,62,539,34,72,106,212,751,0.007688393,116.2897135
KEMBANG JANGGUT,170,526,167,88,781,45,53,124,222,1003,0.248967148,116.1910117
TABANG,180,188,88,25,301,17,15,46,78,379,0.883736704,115.8764117
MUARA ANCALONG,10,976,351,285,1612,67,40,139,246,1858,0.380746107,116.5396006
BUSANG,11,439,190,91,720,13,35,84,132,852,0.989048168,116.3024103
LONG MESANGAT,12,480,142,71,693,21,23,77,121,814,0.601470414,116.7163775
MUARA WAHAU,20,358,131,75,564,13,23,62,98,662,1.399871659,116.5597931
TELEN,21,211,95,41,347,15,14,59,88,435,0.927484263,116.7241117
KONGBENG,22,390,156,112,658,39,46,115,200,858,1.240636662,117.0062924
MUARA BENGKAL,30,372,175,142,689,14,14,68,96,785,0.351091555,116.7923347
BATU AMPAR,31,492,197,78,767,27,36,101,164,931,0.651444737,116.8754845
SANGATTA UTARA,40,930,373,226,1529,10,29,168,207,1736,0.565842748,117.556315
BENGALON,41,832,278,180,1290,23,48,124,195,1485,0.908897139,117.3951721
TELUK PANDAN,42,775,312,172,1259,29,27,134,190,1449,0.196212624,117.3269354
SANGATTA SELATAN,43,740,240,116,1096,21,80,161,262,1358,0.436897835,117.3233599
RANTAU PULUNG,44,504,210,110,824,12,60,94,166,990,0.673432819,117.1937986
SANGKULIRANG,50,135,58,24,217,21,24,47,92,309,1.058747447,118.02588
KALIORANG,51,450,175,109,734,39,38,84,161,895,0.854720776,117.8780457
SANDARAN,52,485,190,79,754,2,11,115,128,882,1.008023511,118.5153317
KAUBUN,53,331,152,72,555,71,57,86,214,769,1.032968947,117.744193
KARANGAN,54,78,13,12,103,11,9,8,28,131,1.347031144,117.5870629
KELAY,10,123,48,9,180,52,42,74,168,348,1.794858427,116.801667
TALISAYAN,20,206,76,35,317,34,16,50,100,417,1.396650934,118.1351303
TABALAR,21,247,58,23,328,54,39,64,157,485,1.700228924,117.7578742
BIDUK BIDUK,30,410,138,105,653,46,35,80,161,814,1.172519651,118.6941873
PULAU DERAWAN,40,383,79,23,485,27,30,81,138,623,2.233036906,117.9072156
MARATUA,41,331,102,77,510,5,12,57,74,584,2.195808601,118.5823615
SAMBALIUNG,50,716,268,87,1071,18,36,163,217,1288,1.948767873,117.5325516
TANJUNG REDEB,60,563,271,150,984,26,30,68,124,1108,2.128169882,117.4674854
GUNUNG TABUR,70,715,240,137,1092,61,66,147,274,1366,2.324672701,117.5169138
SEGAH,80,419,114,50,583,34,78,147,259,842,2.250171606,116.9591891
TELUK BAYUR,90,249,97,54,400,30,26,46,102,502,2.024351282,117.2917349
BATU PUTIH,100,285,93,41,419,34,36,63,133,552,1.349982119,118.3543608
BIATAN,110,119,29,29,177,7,8,17,32,209,1.477136581,117.9897659
KAYAN HULU,10,99,28,14,141,4,2,8,14,155,1.781696579,114.8586287
SUNGAI BOH,11,70,33,10,113,6,9,25,40,153,1.393141364,115.3134386
KAYAN SELATAN,12,107,40,17,164,2,5,10,17,181,1.505829708,114.9280091
KAYAN HILIR,20,118,36,7,161,9,11,38,58,219,1.969715142,115.560906
PUJUNGAN,30,112,42,11,165,11,12,33,56,221,2.640992918,115.650127
BAHAU HULU,31,41,17,13,71,3,1,3,7,78,3.156100691,115.7563283
MALINAU KOTA,40,565,233,137,935,30,18,96,144,1079,3.561114605,116.681561
MALINAU SELATAN,41,482,145,52,679,12,26,66,104,783,3.014006198,116.3687688
MALINAU BARAT,42,470,200,121,791,10,14,70,94,885,3.365330264,116.6490751
MALINAU UTARA,43,669,296,145,1110,36,33,83,152,1262,3.695864512,116.5017269
MENTARANG,50,235,84,31,350,40,40,41,121,471,3.302081915,116.166225
MENTARANG HULU,51,95,25,3,123,14,16,19,49,172,3.799766643,116.1382099
PESO,10,116,55,21,192,13,15,47,75,267,2.566717315,116.5080217
PESO HILIR,11,306,139,62,507,23,22,57,102,609,2.810136229,116.9595723
TANJUNG PALAS,20,410,182,106,698,16,45,111,172,870,2.788995262,117.3054115
TANJUNG PALAS BARAT,21,172,67,30,269,19,18,31,68,337,2.730249168,117.1717233
TANJUNG PALAS UTARA,22,211,114,54,379,12,8,37,57,436,3.026326785,117.1783041
TANJUNG PALAS TIMUR,23,208,80,30,318,91,43,105,239,557,2.577553022,117.6834792
TANJUNG SELOR,24,716,294,121,1131,65,71,153,289,1420,2.766351643,117.4369366
TANJUNG PALAS TENGAH,25,336,133,51,520,23,32,87,142,662,2.992709961,117.4745388
SEKATAK,30,274,90,32,396,128,61,111,300,696,3.238138614,117.0596715
BUNYU,50,127,49,36,212,5,7,21,33,245,3.527242046,117.6628263
KRAYAN,10,169,81,43,293,5,4,22,31,324,4.064214025,115.8377819
KRAYAN SELATAN,11,86,32,25,143,8,2,18,28,171,3.646705219,115.7839978
LUMBIS,20,1272,411,211,1894,45,69,177,291,2185,4.075480556,116.4599362
SEMBAKUNG,30,838,315,203,1356,94,59,118,271,1627,3.789743329,117.1721637
NUNUKAN,40,2652,1002,474,4128,159,146,383,688,4816,4.104803989,117.3970826
SEBUKU,41,898,307,222,1427,97,87,160,344,1771,4.099021197,116.9754911
NUNUKAN SELATAN,42,688,242,121,1051,84,69,101,254,1305,4.050192027,117.696373
SEBATIK,50,1335,539,295,2169,123,94,232,449,2618,4.097632581,117.8801361
SEBATIK BARAT,51,682,242,146,1070,61,60,121,242,1312,4.126451115,117.789019
BABULU,10,1970,809,455,3234,93,156,406,655,3889,-1.475232824,116.4457804
WARU,20,756,359,196,1311,52,56,192,300,1611,-1.320440573,116.4794827
PENAJAM,30,2785,1104,589,4478,232,313,610,1155,5633,-1.177200975,116.5910283
SEPAKU,40,1788,742,361,2891,67,119,387,573,3464,-0.945475616,116.7166382
SESAYAP,10,209,78,36,323,11,23,39,73,396,3.523151224,116.8676319
SESAYAP HILIR,20,249,84,52,385,18,15,35,68,453,3.51655614,117.2153482
TANA LIA,30,243,107,66,416,35,19,47,101,517,3.702224604,117.6374538
BALIKPAPAN SELATAN,10,3347,1526,930,5803,108,152,458,718,6521,-1.252067148,116.8779765
BALIKPAPAN TIMUR,20,1525,709,412,2646,85,78,230,393,3039,-1.17502233,116.959097
BALIKPAPAN UTARA,30,2804,1145,702,4651,82,96,459,637,5288,-1.156222372,116.8794611
BALIKPAPAN TENGAH,40,1450,664,384,2498,33,41,237,311,2809,-1.251970836,116.8358566
BALIKPAPAN BARAT,50,3294,1401,748,5443,60,185,571,816,6259,-1.127860728,116.8012011
PALARAN,10,1209,469,282,1960,100,79,238,417,2377,-0.615487088,117.1865145
SAMARINDA ILIR,20,1381,502,239,2122,52,130,299,481,2603,-0.525966277,117.2096899
SAMARINDA KOTA,21,359,131,85,575,4,12,46,62,637,,
SAMBUTAN,22,755,297,144,1196,25,68,164,257,1453,,
SAMARINDA SEBERANG,30,893,333,209,1435,62,78,172,312,1747,-0.546073497,117.1192575
LOA JANAN ILIR,31,364,139,70,573,148,81,130,359,932,,
SUNGAI KUNJANG,40,691,307,159,1157,53,54,146,253,1410,-0.507625609,117.0807118
SAMARINDA ULU,50,1438,560,277,2275,52,113,266,431,2706,-0.455679715,117.1169066
SAMARINDA UTARA,60,2000,706,375,3081,74,162,469,705,3786,-0.410890969,117.2110341
SUNGAI PINANG,61,1174,434,233,1841,133,122,246,501,2342,,
TARAKAN TIMUR,10,1537,555,317,2409,50,99,318,467,2876,3.300927456,117.6358021
TARAKAN TENGAH,20,1732,698,394,2824,95,111,378,584,3408,3.354258268,117.6142378
TARAKAN BARAT,30,1830,736,365,2931,97,130,335,562,3493,3.334286018,117.5645638
TARAKAN UTARA,40,897,362,176,1435,47,53,164,264,1699,3.399609298,117.5800342
BONTANG SELATAN,10,2287,866,523,3676,95,163,428,686,4362,0.06451338,117.4482174
BONTANG UTARA,20,1993,772,477,3242,61,67,289,417,3659,0.158489088,117.4912216
BONTANG BARAT,30,679,317,224,1220,10,19,94,123,1343,0.141597259,117.4539858
DUMOGA BARAT,21,1498,511,215,2224,71,158,373,602,2826,0.510119228,123.8792032
DUMOGA UTARA,22,791,243,131,1165,57,97,179,333,1498,0.610545804,123.9419022
DUMOGA TIMUR,23,2357,812,372,3541,86,244,604,934,4475,0.649525946,124.1061238
LOLAYAN,60,1257,396,158,1811,135,172,295,602,2413,0.66482217,124.2326413
PASSI BARAT,81,758,263,115,1136,72,99,210,381,1517,0.790295891,124.2576276
PASSI TIMUR,82,576,267,118,961,26,48,136,210,1171,0.807647805,124.3797674
BILALANG,83,557,207,158,922,15,50,97,162,1084,0.835872306,124.3332593
POIGAR,90,760,290,135,1185,41,70,158,269,1454,0.926308304,124.2888167
BOLAANG,100,1221,381,158,1760,52,197,361,610,2370,0.855757735,124.1568087
BOLAANG TIMUR,101,499,125,47,671,30,99,136,265,936,0.917736627,124.1817146
LOLAK,110,1553,512,278,2343,59,193,389,641,2984,0.785614887,123.9967738
SANGTOMBOLANG,120,697,211,107,1015,30,54,117,201,1216,0.716122183,123.7814012
LANGOWAN TIMUR,91,166,59,21,246,2,10,37,49,295,1.133819328,124.8651178
LANGOWAN BARAT,92,676,264,124,1064,34,63,219,316,1380,1.129221727,124.7935647
LANGOWAN SELATAN,93,373,127,53,553,4,22,96,122,675,1.073475666,124.8949639
LANGOWAN UTARA,94,294,101,55,450,11,15,53,79,529,1.162232373,124.8340017
TOMPASO,110,648,251,102,1001,22,21,137,180,1181,1.167069549,124.7924496
KAWANGKOAN,120,196,77,25,298,14,23,55,92,390,1.201048292,124.7740073
KAWANGKOAN BARAT,121,242,93,35,370,3,12,46,61,431,,
KAWANGKOAN UTARA,122,172,50,28,250,5,6,30,41,291,,
SONDER,130,590,273,149,1012,17,29,126,172,1184,1.266553548,124.7685533
TOMBARIRI,160,1583,552,279,2414,36,87,334,457,2871,1.368413194,124.6739617
PINELENG,170,1535,607,263,2405,59,91,426,576,2981,1.407136457,124.7871884
TOMBULU,171,608,245,104,957,23,32,145,200,1157,1.402243246,124.8866758
TONDANO BARAT,190,332,119,59,510,4,26,61,91,601,1.302925937,124.8897292
TONDANO SELATAN,191,518,184,77,779,22,43,132,197,976,1.266502785,124.8771616
REMBOKEN,200,649,266,132,1047,19,40,138,197,1244,1.237888838,124.8483435
KAKAS,210,660,241,105,1006,14,66,167,247,1253,1.137253964,124.9288257
KAKAS BARAT,211,681,228,103,1012,27,54,188,269,1281,,
LEMBEAN TIMUR,220,285,84,34,403,12,25,65,102,505,1.165669981,125.0043056
ERIS,230,534,197,105,836,8,18,107,133,969,,
KOMBI,240,423,152,93,668,7,23,85,115,783,1.246362244,125.0067034
TONDANO TIMUR,250,576,213,157,946,16,28,104,148,1094,1.284282478,124.9415593
TONDANO UTARA,251,338,116,54,508,15,14,87,116,624,,
MANGANITU SELATAN,40,391,137,67,595,56,97,141,294,889,3.410691261,125.6114054
TATOARENG,41,99,25,7,131,4,10,23,37,168,3.171591141,125.4958896
TAMAKO,50,569,233,109,911,38,90,176,304,1215,3.45939221,125.5442065
TABUKAN SELATAN,60,473,196,64,733,25,58,159,242,975,3.498600385,125.611705
TABUKAN SELATAN TENGAH,61,196,107,69,372,13,15,47,75,447,3.465096992,125.6661245
TABUKAN SELATAN TENGGARA,62,188,96,72,356,11,8,40,59,415,3.444707058,125.6376022
TABUKAN TENGAH,70,622,209,103,934,63,108,240,411,1345,3.566182714,125.5654848
MANGANITU,80,547,226,113,886,27,60,120,207,1093,3.531610594,125.515014
TAHUNA,90,245,62,46,353,44,31,83,158,511,3.624973011,125.4836364
TAHUNA TIMUR,91,109,48,27,184,8,17,21,46,230,3.598050702,125.5087164
TAHUNA BARAT,92,202,63,33,298,8,19,43,70,368,3.6436416,125.4517935
TABUKAN UTARA,100,662,207,79,948,31,105,228,364,1312,3.676826826,125.5086033
NUSA TABUKAN,101,200,69,34,303,17,32,46,95,398,3.773194227,125.5887118
KEPULAUAN MARORE,102,113,34,28,175,7,13,24,44,219,4.70464305,125.4820024
KENDAHE,110,418,136,65,619,16,45,100,161,780,3.706613842,125.4262046
KABARUAN,10,350,152,78,580,8,7,43,58,638,3.809827188,126.7719205
DAMAU,11,266,89,54,409,7,6,28,41,450,3.773032238,126.8152712
LIRUNG,20,300,136,73,509,6,11,55,72,581,3.94256826,126.6727053
SALIBABU,21,253,76,49,378,6,16,35,57,435,3.874700716,126.6834134
KALONGAN,22,254,85,29,368,6,21,31,58,426,4.00176775,126.6318918
MORONGE,23,97,30,19,146,3,1,2,6,152,3.90271792,126.7087917
MELONGUANE,30,402,123,84,609,6,11,35,52,661,4.03426596,126.7141327
MELONGUANE TIMUR,31,234,104,70,408,11,9,44,64,472,4.045336548,126.7768125
BEO,40,341,127,88,556,12,24,67,103,659,4.243275859,126.8051752
BEO UTARA,41,315,148,87,550,16,21,75,112,662,4.320139496,126.751263
BEO SELATAN,42,286,106,74,466,7,10,51,68,534,4.134551922,126.75479
RAINIS,50,522,209,106,837,13,24,52,89,926,4.248605921,126.8525456
TAMPANNAMMA,51,545,199,66,810,4,24,58,86,896,4.359746602,126.8289766
PULUTAN,52,158,60,29,247,0,11,14,25,272,4.116059699,126.7823748
ESSANG,60,217,77,74,368,4,6,30,40,408,4.472635924,126.7406407
ESSANG SELATAN,61,262,106,46,414,3,9,35,47,461,4.397061648,126.7244277
GEMEH,70,543,168,73,784,8,11,60,79,863,4.471935089,126.7985927
NANUSA,80,245,104,40,389,4,4,63,71,460,4.731321663,127.1130002
MIANGAS,81,55,24,10,89,1,1,3,5,94,5.556905863,126.5835588
MODOINDING,10,782,241,82,1105,19,54,149,222,1327,0.807440459,124.4543289
TOMPASO BARU,20,795,327,141,1263,28,55,182,265,1528,0.928925991,124.4873374
MAESAAN,21,760,256,112,1128,14,35,134,183,1311,0.873525477,124.4614595
RANOYAPO,70,925,435,171,1531,74,48,199,321,1852,0.988069588,124.5159653
MOTOLING,80,471,186,102,759,9,15,100,124,883,1.026690976,124.4690204
KUMELEMBUAI,81,309,112,34,455,10,10,38,58,513,1.082646999,124.4773624
MOTOLING BARAT,82,668,262,120,1050,19,37,100,156,1206,1.013229681,124.4022558
MOTOLING TIMUR,83,553,231,97,881,5,14,99,118,999,1.058923575,124.5242163
SINONSAYANG,90,1091,435,173,1699,101,114,290,505,2204,1.075083182,124.3584583
TENGA,100,1163,433,198,1794,55,80,233,368,2162,1.142243545,124.4332871
AMURANG,111,841,352,140,1333,21,55,180,256,1589,1.130754477,124.6131674
AMURANG BARAT,112,726,245,102,1073,25,43,147,215,1288,1.147728241,124.5354079
AMURANG TIMUR,113,763,264,120,1147,16,47,146,209,1356,1.170785381,124.6681461
TARERAN,120,726,295,164,1185,13,36,142,191,1376,1.226498304,124.7028341
SULTA,121,348,145,70,563,5,13,70,88,651,1.263607052,124.695786
TUMPAAN,130,1064,386,161,1611,38,93,274,405,2016,1.293518608,124.6562462
TATAPAAN,131,776,261,138,1175,26,62,182,270,1445,1.316142266,124.572368
KEMA,10,798,257,106,1161,49,73,167,289,1450,,
KAUDITAN,20,1240,488,213,1941,48,82,295,425,2366,1.390786592,125.0200633
AIRMADIDI,30,934,354,156,1444,45,65,199,309,1753,1.40193671,124.9663289
KALAWAT,40,858,351,151,1360,28,70,231,329,1689,1.450995393,124.9291466
DIMEMBE,50,1151,426,201,1778,44,72,280,396,2174,1.523608725,125.0071043
TALAWAAN,51,659,276,127,1062,17,41,140,198,1260,1.568874428,124.9391227
WORI,60,1309,537,236,2082,45,91,341,477,2559,1.646611431,124.8602988
LIKUPANG BARAT,70,1146,493,234,1873,49,94,308,451,2324,1.721547194,125.0036436
LIKUPANG TIMUR,80,956,338,164,1458,68,112,259,439,1897,1.665337717,125.1131417
LIKUPANG SELATAN,81,295,109,62,466,6,20,53,79,545,1.624656214,125.0225895
SANGKUB,10,480,172,77,729,22,40,117,179,908,0.859565156,123.6416136
BINTAUNA,20,662,256,143,1061,25,50,127,202,1263,0.715062164,123.6046783
BOLANG ITANG TIMUR,30,649,236,160,1045,122,44,104,270,1315,0.768274895,123.4534929
BOLANG ITANG BARAT,40,692,184,104,980,29,61,108,198,1178,0.784553453,123.3357192
KAIDIPANG,50,353,83,40,476,12,32,66,110,586,0.89177544,123.2540049
PINOGALUMAN,60,402,143,79,624,36,22,65,123,747,0.879598181,123.1954411
BIARO,10,116,47,22,185,4,9,23,36,221,2.102515228,125.3700614
TAGULANDANG SELATAN,20,105,48,12,165,9,10,19,38,203,2.343208794,125.4452714
TAGULANDANG,30,378,169,62,609,19,34,84,137,746,2.334832112,125.3805365
TAGULANDANG UTARA,40,99,37,17,153,4,8,28,40,193,2.356167163,125.4242751
SIAU BARAT SELATAN,50,59,16,4,79,1,0,13,14,93,2.653217292,125.3919287
SIAU TIMUR SELATAN,60,149,52,34,235,9,12,22,43,278,2.666773472,125.4220057
SIAU BARAT,70,109,29,19,157,3,3,13,19,176,2.726552225,125.3410029
SIAU TENGAH,80,28,11,2,41,0,1,1,2,43,2.73820077,125.3819689
SIAU TIMUR,90,282,115,51,448,9,16,49,74,522,2.757947139,125.4191635
SIAU BARAT UTARA,100,57,24,7,88,1,2,5,8,96,2.787151984,125.3931041
RATATOTOK,10,884,278,74,1236,37,107,206,350,1586,0.916960572,124.7085958
PUSOMAEN,20,508,188,78,774,22,48,118,188,962,1.009190716,124.8692076
BELANG,30,726,233,94,1053,23,81,141,245,1298,0.968586858,124.7918542
RATAHAN,40,574,207,116,897,16,39,117,172,1069,1.051912568,124.7954845
PASAN,41,359,133,84,576,5,34,68,107,683,1.035164905,124.7475705
RATAHAN TIMUR,42,276,108,60,444,9,16,56,81,525,1.07340658,124.8402788
TOMBATU,50,725,249,99,1073,18,32,110,160,1233,0.988317759,124.6671597
TOMBATU TIMUR,51,487,180,90,757,2,28,108,138,895,1.017844782,124.7182469
TOMBATU UTARA,52,508,198,82,788,6,26,97,129,917,1.065058428,124.703133
TOULUAAN,60,285,105,50,440,5,19,48,72,512,1.063522813,124.6214705
TOULUAAN SELATAN,61,325,120,23,468,7,20,70,97,565,1.01260023,124.5933652
SILIAN RAYA,62,313,117,46,476,8,26,85,119,595,1.078859341,124.6595511
POSIGADAN,10,1270,387,189,1846,72,73,224,369,2215,0.42666962,123.6322692
BOLANG UKI,20,1609,582,383,2574,61,59,200,320,2894,0.399036139,123.9020801
PINOLOSIAN,30,532,190,104,826,28,47,109,184,1010,0.460375217,124.1208633
PINOLOSIAN TENGAH,40,292,125,49,466,17,27,74,118,584,0.472334902,124.2490355
PINOLOSIAN TIMUR,50,579,181,120,880,109,87,95,291,1171,0.516139797,124.3739505
NUANGAN,10,777,226,84,1087,83,132,229,444,1531,0.627468702,124.506784
TUTUYAN,20,362,122,55,539,30,44,101,175,714,0.772869879,124.5776852
KOTABUNAN,30,584,160,62,806,56,110,170,336,1142,0.870284831,124.6243961
MODAYAG,40,748,255,103,1106,29,90,174,293,1399,0.693773409,124.4371496
MODAYAG BARAT,50,403,114,49,566,20,35,86,141,707,0.669134583,124.3593253
MALALAYANG,10,988,435,194,1617,25,77,193,295,1912,1.44747165,124.8173336
SARIO,20,264,112,69,445,21,15,57,93,538,1.468407127,124.8343254
WANEA,21,1316,557,242,2115,39,73,297,409,2524,1.456388752,124.8481416
WENANG,30,619,218,98,935,31,33,129,193,1128,1.484813957,124.8420578
TIKALA,31,2192,857,495,3544,117,155,495,767,4311,1.473209463,124.8754475
MAPANGET,40,1709,666,299,2674,102,126,389,617,3291,1.533727779,124.891898
SINGKIL,51,1625,624,327,2576,154,168,383,705,3281,1.499442219,124.8584687
TUMINTING,52,1829,592,284,2705,127,184,446,757,3462,1.511921323,124.8494172
BUNAKEN,53,832,339,180,1351,64,71,193,328,1679,1.583583508,124.788616
MADIDIR,10,1166,451,200,1817,56,97,311,464,2281,1.458313837,125.1505417
MATUARI,11,1034,302,147,1483,67,115,244,426,1909,1.406667825,125.0943676
GIRIAN,12,808,274,115,1197,72,107,220,399,1596,1.436716161,125.1165644
LEMBEH SELATAN,21,704,246,92,1042,27,72,192,291,1333,1.420480958,125.2131361
LEMBEH UTARA,22,577,223,153,953,26,36,135,197,1150,1.476562503,125.2579955
AERTEMBAGA,30,1022,365,180,1567,188,143,246,577,2144,1.503407516,125.2013118
MAESA,31,1560,442,225,2227,97,184,375,656,2883,1.462813792,125.1814477
RANOWULU,40,706,233,100,1039,44,89,204,337,1376,1.504123153,125.1096856
TOMOHON SELATAN,10,828,331,182,1341,14,20,113,147,1488,1.286529736,124.8227187
TOMOHON TENGAH,20,523,217,94,834,9,21,98,128,962,1.319538872,124.8484082
TOMOHON TIMUR,21,380,186,116,682,11,6,64,81,763,1.337814166,124.8693408
TOMOHON BARAT,22,825,352,178,1355,14,28,120,162,1517,1.317327841,124.7714487
TOMOHON UTARA,30,1138,429,200,1767,36,70,215,321,2088,1.359188086,124.8223419
KOTAMOBAGU SELATAN,10,1273,348,150,1771,67,198,344,609,2380,0.713294302,124.2970274
KOTAMOBAGU TIMUR,20,1013,359,192,1564,48,100,250,398,1962,0.732524972,124.3325657
KOTAMOBAGU BARAT,30,1147,390,196,1733,47,93,228,368,2101,0.740109598,124.297461
KOTAMOBAGU UTARA,40,481,202,95,778,29,60,179,268,1046,0.758458231,124.3256212
LABOBO,10,198,49,20,267,14,21,35,70,337,-1.731973208,123.3312326
BOKAN KEPULAUAN,11,515,154,59,728,23,70,123,216,944,-1.963253217,123.802473
BANGKURUNG,12,281,75,35,391,11,17,51,79,470,-1.85234013,123.0985328
BANGGAI,20,221,48,27,296,29,21,39,89,385,-1.602588425,123.5428884
BANGGAI UTARA,21,170,42,25,237,15,21,36,72,309,-1.534159873,123.5284809
BANGGAI TENGAH,22,205,42,18,265,18,20,40,78,343,-1.652253224,123.5136501
BANGGAI SELATAN,23,250,66,40,356,31,36,34,101,457,-1.686917605,123.560205
TOTIKUM,30,350,85,26,461,32,42,70,144,605,-1.357543701,123.5047727
TOTIKUM SELATAN,31,399,110,55,564,36,58,72,166,730,-1.428903178,123.446174
TINANGKUNG,40,563,115,33,711,24,63,116,203,914,-1.336060748,123.3166577
TINANGKUNG SELATAN,41,364,122,47,533,10,36,74,120,653,-1.452019668,123.3817935
TINANGKUNG UTARA,42,460,131,56,647,24,42,101,167,814,-1.282782447,123.4318398
LIANG,50,392,119,41,552,15,25,48,88,640,-1.567112494,123.2058219
PELING TENGAH,51,661,204,77,942,19,42,97,158,1100,-1.472497514,123.1850716
BULAGI,60,409,118,63,590,22,37,73,132,722,-1.308873663,123.0410278
BULAGI SELATAN,61,852,240,140,1232,139,141,204,484,1716,-1.453966322,122.9504632
BULAGI UTARA,62,747,211,87,1045,29,42,105,176,1221,-1.22115247,123.0738186
BUKO,70,608,185,74,867,68,71,112,251,1118,-1.334176857,122.8569297
BUKO SELATAN,71,528,152,69,749,40,35,91,166,915,-1.484443825,122.8499129
TOILI,10,1112,308,161,1581,101,167,291,559,2140,-1.321529953,122.1925453
TOILI BARAT,11,1074,437,374,1885,90,31,42,163,2048,-1.49550513,122.1310475
MOILONG,12,881,292,129,1302,48,58,180,286,1588,-1.404434128,122.3441579
BATUI,20,959,227,101,1287,36,102,206,344,1631,-1.188222763,122.440851
BATUI SELATAN,21,870,261,114,1245,105,93,187,385,1630,-1.253976008,122.318477
BUNTA,30,1165,289,149,1603,139,162,236,537,2140,-0.874311097,122.3463738
NUHON,31,1286,330,141,1757,114,170,248,532,2289,-1.029071946,122.0654888
SIMPANG RAYA,32,524,143,96,763,40,60,97,197,960,-0.961626888,122.2859456
KINTOM,40,1006,315,154,1475,30,51,162,243,1718,-1.091227076,122.5852306
LUWUK,50,2413,722,344,3479,123,165,390,678,4157,-0.939700581,122.7858734
LUWUK TIMUR,51,997,272,118,1387,65,126,211,402,1789,-0.834265349,122.999334
PAGIMANA,60,1351,330,185,1866,100,206,342,648,2514,-0.852675473,122.6677478
BUALEMO,61,918,221,174,1313,39,53,121,213,1526,-0.669614658,123.1305872
LOBU,62,263,99,64,426,14,26,46,86,512,-0.807951838,122.5183502
LAMALA,70,984,370,162,1516,25,79,167,271,1787,-0.940183925,123.2519077
MASAMA,71,504,170,78,752,15,36,73,124,876,-0.805393663,123.1882442
BALANTAK,80,550,155,55,760,27,55,95,177,937,-0.797547917,123.3738615
BALANTAK SELATAN,81,230,80,27,337,15,23,68,106,443,-0.940066057,123.3418585
MENUI KEPULAUAN,10,920,210,92,1222,51,108,170,329,1551,-3.367109592,122.6741111
BUNGKU SELATAN,20,1307,342,99,1748,68,175,207,450,2198,-3.047044141,122.2856733
BAHODOPI,21,444,141,53,638,17,19,39,75,713,-2.8799877,121.9662925
BUNGKU PESISIR,22,300,86,34,420,9,13,23,45,465,,
BUNGKU TENGAH,30,732,242,120,1094,55,55,105,215,1309,-2.63644428,121.8742853
BUNGKU TIMUR,31,519,168,84,771,12,25,57,94,865,,
BUNGKU BARAT,40,703,248,118,1069,40,59,103,202,1271,-2.384958157,121.7696847
BUMI RAYA,41,641,215,109,965,29,42,116,187,1152,-2.261256263,121.6847002
WITA PONDA,42,493,160,60,713,51,56,106,213,926,-2.353601992,121.5843788
LEMBO,50,466,122,79,667,39,30,66,135,802,-2.236062254,121.2700152
LEMBO RAYA,51,321,84,23,428,23,23,56,102,530,,
MORI ATAS,60,440,146,42,628,19,22,56,97,725,-2.093099773,121.0003418
MORI UTARA,61,386,130,57,573,11,18,62,91,664,-1.797172095,120.9980565
PETASIA,70,759,283,105,1147,32,52,123,207,1354,-2.039362406,121.3546052
SOYO JAYA,71,341,74,27,442,47,34,63,144,586,-1.685748581,121.2448287
PETASIA TIMUR,72,582,195,72,849,49,57,104,210,1059,,
BUNGKU UTARA,80,1058,224,114,1396,231,157,211,599,1995,-1.672731466,121.5906462
MAMOSALATO,81,743,211,61,1015,173,107,168,448,1463,-1.475391922,121.8400431
PAMONA SELATAN,10,1109,354,210,1673,48,53,153,254,1927,-2.12530215,120.6865926
PAMONA BARAT,11,440,127,36,603,16,17,66,99,702,,
PAMONA TENGGARA,12,626,117,26,769,54,31,82,167,936,-2.034564783,120.7675999
LORE SELATAN,20,350,110,94,554,12,8,37,57,611,-1.903405295,120.3272241
LORE BARAT,21,289,95,44,428,11,7,26,44,472,-1.849906643,120.1945084
PAMONA PUSELEMBA,30,878,350,142,1370,12,26,104,142,1512,,
PAMONA TIMUR,31,904,304,166,1374,21,49,159,229,1603,-1.869081603,120.7939717
PAMONA UTARA,32,806,301,129,1236,25,39,125,189,1425,-1.714715714,120.6707755
LORE UTARA,40,825,223,105,1153,83,122,178,383,1536,-1.35000158,120.3041666
LORE TENGAH,41,356,93,24,473,111,52,81,244,717,-1.676032008,120.2926859
LORE TIMUR,42,359,93,41,493,14,29,54,97,590,-1.458009992,120.4025117
LORE PEORE,43,229,53,2,284,8,21,34,63,347,-1.553877784,120.3315399
POSO PESISIR,50,1342,461,173,1976,50,86,205,341,2317,-1.378421561,120.5643499
POSO PESISIR SELATAN,51,494,146,78,718,24,32,95,151,869,-1.52168388,120.5833138
POSO PESISIR UTARA,52,999,263,140,1402,54,102,192,348,1750,-1.23747411,120.4748408
LAGE,60,1480,510,270,2260,69,95,198,362,2622,-1.517454204,120.8136411
POSO KOTA,70,656,237,120,1013,15,26,91,132,1145,-1.3974123,120.7345339
POSO KOTA UTARA,71,469,178,85,732,15,34,81,130,862,-1.369941363,120.7976599
POSO KOTA SELATAN,72,357,110,43,510,6,19,66,91,601,-1.409148657,120.7579213
RIO PAKAVA,41,1047,252,111,1410,327,225,286,838,2248,-1.29945029,119.626162
PINEMBANI,51,672,189,72,933,492,155,224,871,1804,-1.086871034,119.6908835
BANAWA,80,2086,599,240,2925,131,236,474,841,3766,-0.737305477,119.7555878
BANAWA SELATAN,81,1959,546,225,2730,271,286,474,1031,3761,-0.888995982,119.6534818
BANAWA TENGAH,82,887,234,116,1237,96,129,205,430,1667,-0.759006518,119.7181853
LABUAN,90,1065,244,106,1415,93,160,263,516,1931,-0.608894649,119.9072147
TANANTOVEA,91,781,215,99,1095,32,65,188,285,1380,-0.713704102,119.962353
SINDUE,100,1301,445,198,1944,111,131,278,520,2464,-0.565365136,119.8512892
SINDUE TOMBUSABORA,101,1179,307,115,1601,81,155,227,463,2064,-0.469071173,119.8382741
SINDUE TOBATA,102,798,234,85,1117,82,119,190,391,1508,-0.372978104,119.8378895
SIRENJA,120,1428,419,193,2040,106,164,264,534,2574,-0.250119463,119.8636153
BALAESANG,130,1898,546,231,2675,179,203,380,762,3437,-0.025507267,119.896904
BALAESANG TANJUNG,131,1177,308,125,1610,117,140,203,460,2070,-0.067044349,119.6996099
DAMSOL,140,1747,417,133,2297,126,226,370,722,3019,0.242462005,119.9475993
SOJOL,160,2011,562,233,2806,250,259,383,892,3698,0.506171534,120.0592125
SOJOL UTARA,161,497,108,48,653,51,72,111,234,887,0.69371173,120.1287566
DAMPAL SELATAN,10,1035,273,78,1386,106,167,272,545,1931,0.732888752,120.2599497
DAMPAL UTARA,20,1192,295,82,1569,206,242,330,778,2347,0.930529403,120.3115384
DONDO,30,1622,360,171,2153,235,223,421,879,3032,0.720697555,120.4593153
OGODEIDE,31,943,237,84,1264,72,141,243,456,1720,0.884553259,120.6757249
BASIDONDO,32,932,220,87,1239,73,105,190,368,1607,0.724512563,120.7074799
BAOLAN,40,1616,440,210,2266,92,164,322,578,2844,1.014644303,120.8836117
LAMPASIO,41,980,272,109,1361,105,153,254,512,1873,0.890137216,120.8824955
GALANG,50,1353,342,159,1854,183,183,305,671,2525,1.128111249,120.9237916
TOLITOLI UTARA,60,1539,375,110,2024,84,158,328,570,2594,1.258840562,121.0351658
DAKO PAMEAN,61,701,132,72,905,42,73,146,261,1166,1.244173877,120.8953482
LAKEA,10,1065,308,163,1536,16,33,83,132,1668,1.173097577,121.1974448
BIAU,11,1222,370,160,1752,21,56,160,237,1989,1.192385218,121.4020432
KARAMAT,12,929,263,112,1304,14,47,138,199,1503,1.246594951,121.383774
MOMUNU,20,1373,410,187,1970,58,72,152,282,2252,1.107679996,121.3698743
TILOAN,21,310,119,48,477,25,14,41,80,557,0.897338003,121.1307769
BOKAT,30,1200,428,179,1807,37,49,129,215,2022,0.982167089,121.5122613
BUKAL,31,1235,360,166,1761,58,102,212,372,2133,0.933543823,121.3948984
BUNOBOGU,40,756,230,134,1120,19,28,93,140,1260,0.96434257,121.6112361
GADUNG,41,1104,322,171,1597,42,78,162,282,1879,1.000175924,121.7317736
PALELEH,50,1061,266,103,1430,39,79,146,264,1694,1.00504961,121.9972021
PALELEH BARAT,51,619,207,75,901,23,37,79,139,1040,1.037250583,121.8412672
SAUSU,10,954,221,100,1275,69,120,194,383,1658,-1.074345487,120.4787799
TORUE,11,653,180,69,902,44,65,126,235,1137,-1.042920923,120.2780171
BALINGGI,12,419,117,56,592,18,46,73,137,729,-1.050834913,120.380993
PARIGI,20,1065,283,173,1521,48,96,213,357,1878,-0.812432161,120.1654088
PARIGI SELATAN,21,965,255,112,1332,70,107,178,355,1687,-0.943353144,120.1652461
PARIGI BARAT,22,539,172,77,788,43,37,103,183,971,-0.845310756,120.0982108
PARIGI UTARA,23,370,110,44,524,17,26,63,106,630,-0.709410414,120.0573114
PARIGI TENGAH,24,531,172,108,811,28,42,83,153,964,-0.781620208,120.0816787
AMPIBABO,30,1613,455,230,2298,118,139,274,531,2829,-0.459487584,119.9971705
KASIMBAR,31,1663,460,217,2340,48,126,277,451,2791,-0.144383631,119.975256
TORIBULU,32,1116,276,106,1498,81,96,178,355,1853,-0.334888377,119.9730893
SINIU,33,897,238,133,1268,37,73,124,234,1502,-0.574280325,120.0181638
TINOMBO,40,3090,639,189,3918,966,728,916,2610,6528,0.370530621,120.1738072
TINOMBO SELATAN,41,2188,583,226,2997,152,258,419,829,3826,0.054095612,120.0407142
TOMINI,50,1674,349,146,2169,219,277,355,851,3020,0.570601311,120.5462513
MEPANGA,51,1626,403,153,2182,176,265,425,866,3048,0.5694273,120.6999992
PALASA,52,2475,585,190,3250,939,618,790,2347,5597,0.559237164,120.3513029
MOUTONG,60,1712,498,200,2410,190,284,496,970,3380,0.560348885,121.1833689
BOLANO LAMBUNU,61,3845,970,408,5223,260,464,795,1519,6742,0.558270684,120.8899404
TAOPA,62,1067,216,95,1378,69,117,203,389,1767,0.532944425,121.0615789
TOJO BARAT,10,649,193,82,924,30,39,94,163,1087,-1.511098377,120.9941583
TOJO,20,731,216,64,1011,34,77,150,261,1272,-1.334486685,121.3078894
ULUBONGKA,30,1446,304,86,1836,218,205,326,749,2585,-1.189553366,121.5925197
AMPANA TETE,40,1663,447,180,2290,156,218,362,736,3026,-1.12240227,121.8373259
AMPANA KOTA,50,1563,463,191,2217,101,173,286,560,2777,-0.924003458,121.5733897
UNA - UNA,60,1367,389,146,1902,72,136,236,444,2346,-0.407575864,121.7651621
TOGEAN,70,946,150,34,1130,53,118,185,356,1486,-0.382818387,121.9688869
WALEA KEPULAUAN,80,936,241,112,1289,76,91,182,349,1638,-0.325344645,122.1240583
WALEA BESAR,81,368,123,46,537,22,27,42,91,628,-0.281774544,122.3064111
PIPIKORO,10,812,139,31,982,72,155,230,457,1439,-1.83104647,119.9621284
KULAWI SELATAN,20,660,139,51,850,101,107,152,360,1210,-1.665459321,120.0665535
KULAWI,30,791,179,45,1015,46,138,184,368,1383,-1.511247964,119.882325
LINDU,40,226,43,13,282,14,14,49,77,359,-1.358722354,120.1381318
NOKILALAKI,50,300,61,21,382,59,93,115,267,649,-1.203251111,120.1099365
PALOLO,60,1617,421,166,2204,195,235,410,840,3044,-1.13169645,120.1326442
GUMBASA,70,397,105,57,559,54,43,90,187,746,-1.254094611,119.9807247
DOLO SELATAN,80,1016,242,109,1367,96,125,249,470,1837,-1.265581031,119.8409545
DOLO BARAT,90,716,242,149,1107,89,72,162,323,1430,-1.06476221,119.8393378
TANAMBULAVA,100,409,95,41,545,14,54,84,152,697,-1.135774354,119.9419481
DOLO,110,953,332,148,1433,43,95,244,382,1815,-1.014031055,119.8674694
SIGI BIROMARU,120,1488,508,216,2212,77,171,348,596,2808,-0.992168131,119.9708319
MARAWOLA,130,607,170,80,857,43,48,152,243,1100,-0.97333348,119.8554315
MARAWOLA BARAT,140,637,125,54,816,288,260,278,826,1642,-0.963770466,119.7374397
KINOVARO,150,697,135,56,888,180,194,296,670,1558,-0.945653316,119.8117657
PALU BARAT,10,3485,1147,534,5166,183,343,772,1298,6464,-0.86834239,119.8109466
PALU SELATAN,20,3035,1119,605,4759,138,185,524,847,5606,-0.908335263,119.9311798
PALU TIMUR,30,1960,697,321,2978,83,126,322,531,3509,-0.84578631,119.952186
PALU UTARA,40,2742,949,438,4129,79,174,584,837,4966,-0.718198034,119.8898066
PASIMARANNU,10,683,265,161,1109,34,41,70,145,1254,-7.318193644,121.001646
PASILAMBENA,11,760,185,39,984,51,64,100,215,1199,-7.373716514,121.7763496
PASIMASSUNGGU,20,529,141,83,753,43,45,62,150,903,-7.0752606,120.6444033
TAKABONERATE,21,832,221,79,1132,80,110,123,313,1445,-6.796451525,120.8866673
PASIMASSUNGGU TIMUR,22,566,147,71,784,20,27,70,117,901,-7.094391464,120.7399542
BONTOSIKUYU,30,637,195,81,913,56,57,92,205,1118,-6.341310509,120.4847753
BONTOHARU,40,884,258,93,1235,62,73,125,260,1495,-6.155149833,120.4765802
BENTENG,41,511,149,41,701,23,39,76,138,839,-6.116499377,120.4656157
BONTOMANAI,42,589,165,91,845,18,22,52,92,937,-6.052747856,120.5119056
BONTOMATENE,50,637,289,138,1064,24,22,54,100,1164,-5.87559629,120.4890975
BUKI,51,357,136,58,551,10,10,40,60,611,-5.979937777,120.5004083
GANTARANG,10,1892,458,222,2572,509,449,558,1516,4088,-5.510321236,120.141174
UJUNG BULU,20,1256,311,131,1698,294,272,394,960,2658,-5.547225824,120.200681
UJUNG LOE,21,1682,496,156,2334,313,268,390,971,3305,-5.471576474,120.2751974
BONTO BAHARI,30,719,170,68,957,113,142,146,401,1358,-5.549363488,120.4063155
BONTOTIRO,40,874,417,229,1520,191,93,199,483,2003,-5.468744844,120.3892709
HERO LANGE-LANGE,50,1192,399,183,1774,99,90,146,335,2109,-5.405789583,120.3685395
KAJANG,60,2385,830,400,3615,485,417,618,1520,5135,-5.340840984,120.3174584
BULUKUMPA,70,2108,678,294,3080,303,266,477,1046,4126,-5.345571049,120.178951
RILAU ALE,80,1574,429,136,2139,151,248,359,758,2897,-5.415214377,120.1835801
KINDANG,90,1247,332,175,1754,126,212,288,626,2380,-5.394792048,120.0585544
BISSAPPU,10,698,245,80,1023,217,146,172,535,1558,-5.538865948,119.903942
ULUERE,11,265,112,27,404,60,78,92,230,634,-5.432274932,119.9331798
SINOA,12,307,134,45,486,148,125,157,430,916,-5.493315367,119.9305056
BANTAENG,20,710,219,81,1010,173,172,235,580,1590,-5.50510047,119.9689636
EREMERASA,21,625,173,53,851,140,199,201,540,1391,-5.476986271,119.989229
TOMPOBULU,30,609,229,107,945,110,106,130,346,1291,-5.43902969,120.0236118
PA'JUKUKANG,31,1175,331,94,1600,306,305,396,1007,2607,-5.552479261,120.0351855
GANTARANGKEKE,32,503,146,47,696,163,187,170,520,1216,-5.52155784,120.0612303
BANGKALA,10,3416,933,465,4814,300,473,849,1622,6436,-5.562636226,119.6020776
BANGKALA BARAT,11,2000,486,208,2694,266,310,499,1075,3769,-5.495139293,119.5611896
TAMALATEA,20,2783,903,439,4125,301,427,687,1415,5540,-5.637258403,119.6666198
BONTORAMBA,21,2019,595,270,2884,267,265,467,999,3883,-5.567179528,119.6851505
BINAMU,30,2830,803,426,4059,266,358,626,1250,5309,-5.672832017,119.7335162
TURATEA,31,2349,747,481,3577,121,219,471,811,4388,-5.603592777,119.7588855
BATANG,40,1352,388,172,1912,94,138,280,512,2424,-5.623419832,119.8128818
ARUNGKEKE,41,1293,389,201,1883,93,142,263,498,2381,-5.664977947,119.8092016
TAROWANG,42,1876,551,260,2687,152,239,409,800,3487,-5.586042675,119.8646948
KELARA,50,1454,463,223,2140,161,262,362,785,2925,-5.551443683,119.8257852
RUMBIA,51,1820,670,320,2810,139,212,444,795,3605,-5.462185596,119.8803438
MANGARA BOMBANG,10,1709,525,267,2501,378,349,546,1273,3774,-5.534332504,119.4589225
MAPPAKASUNGGU,20,819,274,145,1238,56,91,203,350,1588,-5.484194337,119.3013277
SANROBONE,21,538,149,71,758,45,89,136,270,1028,-5.430045325,119.3962967
POLOMBANGKENG SELATAN,30,774,280,123,1177,88,103,217,408,1585,-5.438515835,119.4976909
PATTALLASSANG,31,648,231,102,981,57,76,147,280,1261,-5.432092864,119.4441743
POLOMBANGKENG UTARA,40,1400,417,202,2019,121,194,340,655,2674,-5.367733057,119.5476714
GALESONG SELATAN,50,951,309,133,1393,97,161,334,592,1985,-5.372857585,119.3752254
GALESONG,51,1177,306,153,1636,199,266,414,879,2515,-5.329267979,119.3785848
GALESONG UTARA,60,1112,272,92,1476,180,289,465,934,2410,-5.254005844,119.3876284
BONTONOMPO,10,1726,649,309,2684,75,154,372,601,3285,-5.352854712,119.4338402
BONTONOMPO SELATAN,11,1483,469,248,2200,190,221,395,806,3006,-5.399309187,119.4021547
BAJENG,20,2045,718,332,3095,137,227,567,931,4026,-5.293358306,119.4550709
BAJENG BARAT,21,809,294,167,1270,50,94,212,356,1626,-5.301880286,119.4026863
PALLANGGA,30,2684,840,314,3838,167,320,715,1202,5040,-5.250887714,119.468711
BAROMBONG,31,1408,461,165,2034,90,189,368,647,2681,-5.233430707,119.4120914
SOMBA OPU,40,1648,490,239,2377,242,251,395,888,3265,-5.207342638,119.480684
BONTOMARANNU,50,660,241,111,1012,92,93,159,344,1356,-5.261324866,119.5353632
PATTALLASSANG,51,555,165,77,797,64,80,146,290,1087,-5.206740143,119.5592935
PARANGLOE,60,609,228,106,943,36,59,155,250,1193,-5.219985165,119.6721819
MANUJU,61,571,196,108,875,62,78,150,290,1165,-5.292333152,119.6773703
TINGGIMONCONG,70,519,143,39,701,54,66,130,250,951,-5.247378438,119.8444884
TOMBOLO PAO,71,1374,333,152,1859,134,191,287,612,2471,-5.188807164,119.9322634
PARIGI,72,228,96,43,367,38,45,59,142,509,-5.309639297,119.8451297
BUNGAYA,80,784,249,118,1151,58,53,106,217,1368,-5.361935417,119.7038567
BONTOLEMPANGAN,81,507,209,99,815,92,69,143,304,1119,-5.380187376,119.8228807
TOMPOBULU,90,1181,342,120,1643,145,282,385,812,2455,-5.419260905,119.8631725
BIRINGBULU,91,510,174,82,766,168,135,168,471,1237,-5.484053444,119.7281666
SINJAI BARAT,10,1307,368,147,1822,93,151,267,511,2333,-5.227243671,120.0068397
SINJAI BORONG,20,1061,355,151,1567,102,153,235,490,2057,-5.30124095,120.0487107
SINJAI SELATAN,30,1144,375,160,1679,90,150,219,459,2138,-5.232459081,120.1534047
TELLU LIMPOE,40,1421,538,219,2178,89,192,324,605,2783,-5.265562203,120.2405435
SINJAI TIMUR,50,1088,363,168,1619,80,155,265,500,2119,-5.179590987,120.2512639
SINJAI TENGAH,60,1075,368,143,1586,98,142,226,466,2052,-5.182490143,120.1138461
SINJAI UTARA,70,201,81,31,313,34,26,56,116,429,-5.115609188,120.2418577
BULUPODDO,80,726,276,92,1094,15,51,125,191,1285,-5.100553571,120.1281535
PULAU SEMBILAN,90,197,56,15,268,10,36,61,107,375,-5.074851565,120.4108761
MANDAI,10,1171,419,170,1760,160,132,316,608,2368,-5.077914472,119.5614182
MONCONGLOE,11,758,267,133,1158,31,44,154,229,1387,-5.146709159,119.5553769
MAROS BARU,20,1704,621,288,2613,139,230,485,854,3467,-4.996458386,119.528539
MARUSU,21,1166,370,168,1704,119,206,359,684,2388,-5.034958159,119.5038858
TURIKALE,22,1230,469,190,1889,77,133,329,539,2428,-5.014323236,119.5759945
LAU,23,1330,517,284,2131,82,176,377,635,2766,-4.96226419,119.5612854
BONTOA,30,1902,627,283,2812,206,352,567,1125,3937,-4.916035084,119.5701612
BANTIMURUNG,40,1401,527,265,2193,89,167,331,587,2780,-4.975455211,119.6761124
SIMBANG,41,1577,569,263,2409,80,198,383,661,3070,-5.049416718,119.6793238
TANRALILI,50,1131,380,199,1710,109,163,318,590,2300,-5.097835214,119.6181104
TOMPU BULU,51,1092,311,134,1537,410,277,388,1075,2612,-5.140001899,119.7506585
CAMBA,60,579,152,67,798,46,88,131,265,1063,-4.916724822,119.8453048
CENRANA,61,1013,276,128,1417,90,126,249,465,1882,-5.022204282,119.8055266
MALLAWA,70,559,159,84,802,40,79,125,244,1046,-4.810223578,119.8834092
LIUKANG TANGAYA,10,549,71,26,646,603,219,247,1069,1715,-7.145009839,118.2227798
LIUKANG KALMAS,20,307,20,4,331,62,50,37,149,480,-5.279997859,117.8703966
LIUKANG TUPABBIRING,30,1273,181,50,1504,271,418,434,1123,2627,-4.811853791,119.1808648
LIUKANG TUPABBIRING UTARA,31,828,189,87,1104,124,158,197,479,1583,-4.731977517,119.4336595
PANGKAJENE,40,1190,369,164,1723,252,176,264,692,2415,-4.856928146,119.5411627
MINASATENE,41,1595,529,291,2415,149,196,349,694,3109,-4.843520767,119.6138077
BALOCCI,50,910,350,124,1384,50,86,168,304,1688,-4.905328694,119.7140802
TONDONG TALLASA,51,699,235,138,1072,31,36,74,141,1213,-4.840925644,119.7318377
BUNGORO,60,1426,437,188,2051,193,223,338,754,2805,-4.78306151,119.6098036
LABAKKANG,70,2496,664,308,3468,413,641,790,1844,5312,-4.76133326,119.5530116
MA'RANG,80,1465,456,168,2089,249,296,445,990,3079,-4.703305549,119.5746059
SEGERI,91,937,271,135,1343,169,221,279,669,2012,-4.667720043,119.6147006
MANDALLE,92,829,274,114,1217,94,143,229,466,1683,-4.606845455,119.6104647
TANETE RIAJA,10,980,310,153,1443,70,112,204,386,1829,-4.531656104,119.7200001
PUJANANTING,11,1145,396,190,1731,71,161,226,458,2189,-4.67415976,119.7194872
TANETE RILAU,20,1244,416,158,1818,59,176,291,526,2344,-4.502273653,119.6184817
BARRU,30,1001,340,133,1474,68,154,252,474,1948,-4.420844493,119.6904413
SOPPENG RIAJA,40,505,153,60,718,43,77,114,234,952,-4.262915691,119.6716224
BALUSU,41,557,211,93,861,38,72,120,230,1091,-4.328138337,119.6871802
MALLUSETASI,50,872,301,143,1316,65,100,179,344,1660,-4.15582783,119.67907
BONTOCANI,10,1272,314,108,1694,178,200,278,656,2350,-5.036653596,119.9721571
KAHU,20,1585,475,211,2271,88,148,315,551,2822,-4.972472141,120.0901419
KAJUARA,30,1676,383,149,2208,123,277,434,834,3042,-5.063991331,120.2306415
SALOMEKKO,40,1049,395,179,1623,50,113,237,400,2023,-5.001648886,120.2355589
TONRA,50,792,271,123,1186,52,98,159,309,1495,-4.902164292,120.2621272
PATIMPENG,60,965,245,100,1310,90,150,242,482,1792,-4.906936334,120.1718618
LIBURENG,70,1193,395,160,1748,106,135,261,502,2250,-4.841514712,120.024114
MARE,80,1567,532,205,2304,79,190,363,632,2936,-4.79284538,120.2708757
SIBULUE,90,1891,587,235,2713,150,289,550,989,3702,-4.674116328,120.3763057
CINA,100,1137,342,141,1620,102,191,314,607,2227,-4.68061173,120.2754112
BAREBBO,110,1303,303,114,1720,119,248,381,748,2468,-4.59489134,120.2902969
PONRE,120,850,215,73,1138,200,198,267,665,1803,-4.685266724,120.1468767
LAPPARIAJA,130,1057,322,136,1515,84,157,251,492,2007,-4.714205457,119.9645137
LAMURU,140,837,331,76,1244,101,160,234,495,1739,-4.587909475,119.9578669
TELLU LIMPOE,141,1007,206,94,1307,203,316,357,876,2183,-4.657629991,119.830697
BENGO,150,1240,483,227,1950,71,146,324,541,2491,-4.624667966,120.0540353
ULAWENG,160,810,252,129,1191,222,225,338,785,1976,-4.507412366,120.1271146
PALAKKA,170,1377,414,166,1957,154,300,470,924,2881,-4.535413101,120.2336909
AWANGPONE,180,1725,561,270,2556,142,294,523,959,3515,-4.451563145,120.3010921
TELLU SIATTINGE,190,1638,542,227,2407,340,461,569,1370,3777,-4.401125053,120.2438251
AMALI,200,810,267,113,1190,90,159,263,512,1702,-4.394690968,120.1148342
AJANGALE,210,1191,375,172,1738,145,255,425,825,2563,-4.274715888,120.1361042
DUA BOCCOE,220,1104,323,120,1547,92,205,332,629,2176,-4.317370895,120.2183607
CENRANA,230,1155,496,219,1870,108,157,302,567,2437,-4.311214195,120.3348224
TANETE RIATTANG BARAT,710,1232,389,214,1835,91,171,312,574,2409,-4.525642583,120.3020671
TANETE RIATTANG,720,928,256,99,1283,78,145,239,462,1745,-4.530379979,120.3348352
TANETE RIATTANG TIMUR,730,1887,488,219,2594,173,299,602,1074,3668,-4.524900928,120.3779394
MARIO RIWAWO,10,1623,608,265,2496,128,231,371,730,3226,-4.485266997,119.9459042
LALABATA,20,1248,377,176,1801,171,259,371,801,2602,-4.399839119,119.8350914
LILI RIAJA,30,857,345,155,1357,60,122,189,371,1728,-4.401716855,119.9412293
GANRA,31,236,84,58,378,30,35,63,128,506,-4.300470078,119.9495675
CITTA,32,320,123,47,490,18,54,70,142,632,-4.418944195,120.031317
LILI RILAU,40,875,302,123,1300,87,151,245,483,1783,-4.334070099,120.0300991
DONRI DONRI,50,909,315,138,1362,101,128,214,443,1805,-4.272951947,119.8425431
MARIO RIAWA,60,1019,365,178,1562,195,205,308,708,2270,-4.177379387,119.8222235
SABBANG PARU,10,772,254,87,1113,140,217,328,685,1798,-4.212305992,119.9907333
TEMPE,20,1463,437,177,2077,200,321,502,1023,3100,,
PAMMANA,30,1356,350,131,1837,147,371,529,1047,2884,-4.200100886,120.0900282
BOLA,40,741,109,59,909,262,328,405,995,1904,-4.20633012,120.2412288
TAKKALALLA,50,760,213,76,1049,100,210,285,595,1644,-4.149716757,120.286074
SAJOANGING,60,605,172,52,829,103,199,246,548,1377,-3.977328303,120.2924
PENRANG,61,564,154,54,772,95,189,202,486,1258,-4.072467325,120.2560993
MAJAULENG,70,1405,307,138,1850,293,411,515,1219,3069,-4.042786683,120.1630776
TANA SITOLO,80,1497,440,197,2134,279,442,589,1310,3444,,
BELAWA,90,1247,443,157,1847,94,201,381,676,2523,-3.995732866,119.952665
MANIANG PAJO,100,433,139,54,626,78,122,137,337,963,-3.905977993,120.0901389
GILIRENG,101,461,137,64,662,51,96,172,319,981,-3.888437817,120.1884173
KEERA,110,1063,293,115,1471,125,264,385,774,2245,-3.81507052,120.2878225
PITUMPANUA,120,1613,574,219,2406,178,302,485,965,3371,-3.720119397,120.3667041
PANCA LAUTANG,10,733,209,83,1025,58,90,142,290,1315,-4.065655671,119.8275297
TELLULIMPO E,20,885,278,122,1285,92,141,298,531,1816,-4.024058503,119.7811045
WATANG PULU,30,1229,323,113,1665,113,266,393,772,2437,-3.9493829,119.7346159
BARANTI,40,703,255,133,1091,45,73,116,234,1325,-3.835510918,119.77511
PANCA RIJANG,50,656,229,100,985,21,49,123,193,1178,-3.841562867,119.8510818
KULO,51,336,146,46,528,18,36,64,118,646,-3.780688351,119.7993102
MARITENGNGAE,60,1004,315,123,1442,88,167,265,520,1962,-3.924997943,119.8020878
WATANG SIDENRENG,61,572,158,57,787,68,109,134,311,1098,-3.918291602,119.8681579
PITU RIAWA,70,1049,292,107,1448,46,140,231,417,1865,-3.794826272,119.9563402
DUAPITUE,80,877,257,112,1246,79,123,211,413,1659,-3.895042487,120.0027472
PITU RIASE,81,861,255,102,1218,237,193,270,700,1918,-3.676996412,120.1237103
SUPPA,10,1644,457,216,2317,147,279,421,847,3164,-3.954540542,119.613131
MATTIROSOMPE,20,1089,251,71,1411,137,193,257,587,1998,-3.805237962,119.5385659
LANRISANG,21,749,196,64,1009,62,108,183,353,1362,-3.885693884,119.5766743
MATTIRO BULU,30,889,263,109,1261,44,122,198,364,1625,-3.872573158,119.6510598
WATANG SAWITTO,40,951,297,90,1338,91,130,222,443,1781,-3.798757672,119.6264187
PALETEANG,41,1281,346,142,1769,115,186,310,611,2380,-3.770169067,119.6757896
TIROANG,42,878,238,83,1199,47,132,165,344,1543,-3.81308031,119.7148573
PATAMPANUA,50,1393,429,174,1996,61,129,246,436,2432,-3.718087887,119.6994143
CEMPA,60,820,219,75,1114,65,123,176,364,1478,-3.731251101,119.5430646
DUAMPANUA,70,2278,683,255,3216,139,296,504,939,4155,-3.646550296,119.557327
BATULAPPA,71,793,244,96,1133,55,74,139,268,1401,-3.602541497,119.6847968
LEMBANG,80,2775,746,254,3775,357,505,669,1531,5306,-3.42005527,119.5703251
MAIWA,10,1021,284,103,1408,38,76,141,255,1663,-3.696184858,119.8827712
BUNGIN,11,370,109,78,557,26,30,68,124,681,-3.545125994,119.9883338
ENREKANG,20,1202,379,192,1773,31,73,157,261,2034,-3.508870065,119.7780242
CENDANA,21,272,104,45,421,8,22,29,59,480,-3.640293422,119.7719245
BARAKA,30,1155,495,278,1928,27,31,168,226,2154,-3.419638152,119.9088951
BUNTU BATU,31,1042,370,190,1602,17,41,151,209,1811,-3.451533861,119.9676811
ANGGERAJA,40,926,363,182,1471,74,54,135,263,1734,-3.421933908,119.7831694
MALUA,41,506,203,112,821,19,16,56,91,912,-3.380543151,119.8595038
ALLA,50,662,272,168,1102,16,40,106,162,1264,-3.331977839,119.8247763
CURIO,51,1146,404,214,1764,28,32,118,178,1942,-3.319482191,119.9248848
MASALLE,52,1229,344,126,1699,97,101,168,366,2065,-3.325702983,119.7535286
BAROKO,53,646,247,109,1002,22,23,69,114,1116,-3.273343441,119.8040926
LAROMPONG,10,1294,449,206,1949,67,120,286,473,2422,-3.551512502,120.2910868
LAROMPONG SELATAN,11,885,279,141,1305,69,105,204,378,1683,-3.61702909,120.3595795
SULI,20,1164,397,188,1749,84,76,205,365,2114,-3.444823815,120.3482122
SULI BARAT,21,820,284,117,1221,48,89,175,312,1533,-3.46220893,120.2434079
BELOPA,30,363,129,69,561,47,29,52,128,689,-3.39460469,120.3607247
KAMANRE,31,545,162,59,766,23,43,75,141,907,-3.314410568,120.3514718
BELOPA UTARA,32,298,111,55,464,37,35,55,127,591,-3.358923252,120.3748261
BAJO,40,767,258,141,1166,69,57,146,272,1438,-3.355977989,120.3014312
BAJO BARAT,41,703,233,132,1068,36,40,109,185,1253,-3.361661269,120.2368231
BASSESANGTEMPE,50,1760,613,304,2677,417,225,345,987,3664,-3.178791926,120.0746833
LATIMOJONG,51,636,203,95,934,52,48,110,210,1144,-3.374049162,120.1160881
BUPON,60,968,379,138,1485,49,82,158,289,1774,-3.268383946,120.2220474
PONRANG,61,1622,534,281,2437,209,177,408,794,3231,-3.203703743,120.2665958
PONRANG SELATAN,62,906,314,186,1406,81,71,133,285,1691,-3.258075117,120.3515407
BUA,70,1177,396,100,1673,70,148,291,509,2182,-3.118586434,120.2029094
WALENRANG,80,1109,435,223,1767,55,63,211,329,2096,-2.884994077,120.1150385
WALENRANG TIMUR,81,950,377,230,1557,39,51,132,222,1779,-2.88496488,120.2106408
LAMASI,90,866,384,186,1436,102,73,183,358,1794,-2.804387257,120.1828856
WALENRANG UTARA,91,1002,401,220,1623,92,64,194,350,1973,-2.757731185,120.0945802
WALENRANG BARAT,92,1234,408,177,1819,219,149,287,655,2474,-2.808190546,119.9969974
LAMASI TIMUR,93,1136,521,239,1896,95,118,265,478,2374,-2.867263344,120.2442442
BONGGAKARADENG,10,705,166,67,938,63,119,193,375,1313,-3.228897588,119.6884626
SIMBUANG,11,794,257,33,1084,30,83,200,313,1397,-3.207002872,119.5839255
RANO,12,680,221,94,995,48,43,85,176,1171,-3.23574761,119.7506698
MAPPAK,13,751,228,13,992,15,53,215,283,1275,-3.233152534,119.4625208
MENGKENDEK,20,1633,567,317,2517,53,37,111,201,2718,-3.223132284,119.9381839
GANDANG BATU SILANAN,21,1087,411,196,1694,23,17,111,151,1845,-3.222791182,119.8428646
SANGALLA,30,365,161,75,601,5,13,43,61,662,-3.09188118,119.9033948
SANGALA SELATAN,31,528,183,105,816,2,4,35,41,857,-3.125174291,119.9454826
SANGALLA UTARA,32,384,171,97,652,20,22,94,136,788,-3.066949792,119.9184519
MAKALE,40,908,328,168,1404,50,33,92,175,1579,-3.095051379,119.850305
MAKALE SELATAN,41,1130,347,154,1631,132,70,151,353,1984,-3.157586542,119.8073195
MAKALE UTARA,42,395,166,88,649,13,10,50,73,722,-3.053858615,119.8716929
SALUPUTTI,50,508,162,103,773,31,27,39,97,870,-3.03356273,119.751316
BITTUANG,51,1863,592,266,2721,198,172,289,659,3380,-3.011588794,119.667272
REMBON,52,1619,579,254,2452,66,67,234,367,2819,-3.114476898,119.7748155
MASANDA,53,1032,343,122,1497,79,55,134,268,1765,-2.871194688,119.6231304
MALIMBONG BALEPE,54,943,423,254,1620,133,91,140,364,1984,-3.090946508,119.6964515
RANTETAYO,61,763,278,130,1171,40,39,107,186,1357,-3.038365134,119.8163464
KURRA,67,376,165,63,604,91,47,66,204,808,-2.971586452,119.7635068
SABBANG,10,2905,967,457,4329,112,208,439,759,5088,-2.599565559,120.1318112
BAEBUNTA,20,2817,969,466,4252,131,260,535,926,5178,-2.640136935,120.2733074
MALANGKE,30,1869,625,280,2774,59,174,307,540,3314,-2.751430806,120.4382545
MALANGKE BARAT,31,1572,514,214,2300,71,119,243,433,2733,-2.815345736,120.3242119
SUKAMAJU,40,2126,629,274,3029,72,227,418,717,3746,-2.578047459,120.4727904
BONE-BONE,50,3110,1029,460,4599,126,238,493,857,5456,-2.596922683,120.5636015
MASAMBA,120,1230,356,189,1775,30,62,165,257,2032,-2.38848779,120.3115865
MAPPEDECENG,121,937,285,166,1388,40,59,140,239,1627,-2.547367407,120.4177647
RAMPI,122,258,58,34,350,4,12,38,54,404,-2.131503403,120.3010566
LIMBONG,130,488,117,45,650,35,43,89,167,817,-2.552397077,119.9087103
SEKO,131,1600,406,172,2178,125,203,295,623,2801,-2.246952678,119.8949758
BURAU,10,2251,702,310,3263,56,148,341,545,3808,-2.549990058,120.6694256
WOTU,20,1422,475,209,2106,108,184,337,629,2735,-2.597973676,120.8384517
TOMONI,30,802,268,124,1194,39,75,131,245,1439,-2.444655175,120.6662107
TOMONI TIMUR,31,782,286,99,1167,7,31,92,130,1297,-2.537226072,120.875272
ANGKONA,40,1554,500,236,2290,46,107,244,397,2687,-2.514248309,120.9419011
MALILI,50,1122,349,173,1644,64,87,185,336,1980,-2.689829403,121.1334124
TOWUTI,60,1000,272,110,1382,46,75,148,269,1651,,
NUHA,70,185,68,28,281,12,7,10,29,310,-2.45524679,121.2854472
WASUPONDA,71,901,260,93,1254,16,51,155,222,1476,-2.49238241,121.1075791
MANGKUTANA,80,853,267,105,1225,39,62,130,231,1456,-2.303146256,120.6764946
KALAENA,81,448,139,47,634,7,28,67,102,736,-2.430787909,120.8691512
SOPAI,10,837,304,145,1286,44,46,147,237,1523,-2.997435476,119.8563789
KESU,20,588,236,132,956,23,27,83,133,1089,-2.997462699,119.8977208
SANGGALANGI,30,482,169,102,753,12,20,71,103,856,-3.013552075,119.932468
BUNTAO,40,732,304,128,1164,34,30,112,176,1340,-3.048006554,119.959183
RANTEBUA,50,621,250,118,989,17,26,80,123,1112,-3.070806478,120.0100762
NANGGALA,60,378,128,92,598,11,17,36,64,662,-2.96352207,120.0084907
TONDON,70,463,182,87,732,17,26,49,92,824,-2.95459446,119.94778
TALLUNGLIPU,80,449,161,82,692,27,27,54,108,800,-2.954888157,119.9092605
RANTEPAO,90,643,242,141,1026,17,10,62,89,1115,-2.966424983,119.8812226
TIKALA,100,741,287,162,1190,18,25,86,129,1319,-2.941079219,119.8813401
SESEAN,110,423,167,75,665,26,12,46,84,749,-2.923491219,119.9213575
BALUSU,120,283,120,74,477,67,39,43,149,626,-2.907608009,119.9769085
SA'DAN,130,1278,522,334,2134,71,52,129,252,2386,-2.838674542,119.9231447
BENGKELEKILA,140,307,140,53,500,10,13,43,66,566,-2.889236607,119.8995535
SESEAN SULOARA,150,503,194,89,786,11,7,44,62,848,-2.908022706,119.8700199
KAPALA PITU,160,597,233,111,941,18,23,61,102,1043,-2.928413352,119.841109
DENDE PIONGAN NAPO,170,695,224,140,1059,45,31,85,161,1220,-2.97506066,119.8127859
AWAN RANTE KARUA,180,431,125,43,599,43,66,107,216,815,-2.910669599,119.735991
RINDINGALO,190,541,206,115,862,18,26,57,101,963,-2.890746269,119.8039743
BUNTU PEPASAN,200,1408,502,258,2168,98,87,129,314,2482,-2.797507423,119.8444145
BARUPPU,210,651,236,114,1001,52,52,131,235,1236,-2.760567233,119.7668647
MARISO,10,1379,519,218,2116,135,145,378,658,2774,-5.157392393,119.4087978
MAMAJANG,20,1116,416,202,1734,87,99,294,480,2214,-5.163953805,119.415805
TAMALATE,30,5079,1752,851,7682,442,595,1287,2324,10006,-5.188987645,119.4051246
RAPPOCINI,31,2696,893,377,3966,229,310,709,1248,5214,-5.171727912,119.4438089
MAKASSAR,40,2749,984,453,4186,196,234,673,1103,5289,-5.142637317,119.4259059
UJUNG PANDANG,50,355,133,61,549,10,21,122,153,702,-5.139927347,119.4107824
WAJO,60,294,115,50,459,30,32,100,162,621,-5.125385141,119.4117248
BONTOALA,70,1063,397,187,1647,117,95,313,525,2172,-5.129209824,119.4224991
UJUNG TANAH,80,2047,535,173,2755,176,401,675,1252,4007,-5.069891504,119.3635307
TALLO,90,4196,1424,621,6241,515,600,1224,2339,8580,-5.118153158,119.4444374
PANAKKUKANG,100,3689,1221,569,5479,248,390,956,1594,7073,-5.142315054,119.4536699
MANGGALA,101,1985,732,341,3058,142,195,487,824,3882,-5.170599617,119.4875706
BIRING KANAYA,110,2837,1146,466,4449,301,325,801,1427,5876,-5.096421893,119.5152297
TAMALANREA,111,1270,436,210,1916,112,195,393,700,2616,-5.111832522,119.4818136
BACUKIKI,10,605,231,90,926,45,103,142,290,1216,-4.037566893,119.6723916
BACUKIKI BARAT,11,1555,648,290,2493,60,131,299,490,2983,-4.04358451,119.6337148
UJUNG,20,807,326,123,1256,32,52,154,238,1494,-3.994056695,119.6519369
SOREANG,30,1622,644,287,2553,74,126,282,482,3035,-3.990001049,119.6427677
WARA SELATAN,10,312,145,81,538,19,17,63,99,637,-3.034037331,120.2133995
SENDANA,11,475,190,89,754,30,49,137,216,970,-3.048514005,120.1554071
WARA,20,752,274,153,1179,22,78,164,264,1443,-3.011173069,120.1931741
WARA TIMUR,21,876,304,164,1344,85,130,230,445,1789,-3.004080381,120.2093222
MUNGKAJANG,22,359,141,89,589,11,23,79,113,702,-3.016648767,120.1299453
WARA UTARA,30,556,238,121,915,35,41,171,247,1162,-2.986355052,120.1843221
BARA,31,719,280,153,1152,29,58,150,237,1389,-2.951531603,120.178091
TELLUWANUA,40,1061,406,226,1693,65,104,252,421,2114,-2.916162556,120.1855599
WARA BARAT,41,492,177,96,765,29,42,106,177,942,-2.962753474,120.1128599
LASALIMU,50,374,105,44,523,37,52,69,158,681,-5.217185123,122.9925299
LASALIMU SELATAN,51,977,352,214,1543,46,57,156,259,1802,-5.28979378,123.1254741
SIONTAPINA,52,1215,420,209,1844,81,115,186,382,2226,-5.35596436,123.0394599
PASAR WAJO,60,2447,960,580,3987,71,108,250,429,4416,-5.43194447,122.8337328
WOLOWA,61,476,191,107,774,4,25,34,63,837,-5.386742035,122.9396457
WABULA,62,502,184,107,793,32,20,64,116,909,-5.578395014,122.8463612
SAMPOLAWA,70,1854,658,322,2834,106,82,200,388,3222,-5.57112429,122.7234749
BATU ATAS,71,1238,385,148,1771,50,72,135,257,2028,-6.200904243,122.7011274
LAPANDEWA,72,676,258,175,1109,12,31,67,110,1219,-5.63183785,122.7863771
BATAUGA,80,889,358,204,1451,37,45,107,189,1640,-5.595453488,122.6332916
SIOMPU,81,698,253,157,1108,34,38,98,170,1278,-5.656336448,122.5265815
KADATUA,82,686,210,128,1024,48,50,109,207,1231,-5.534701793,122.4962024
SIOMPU BARAT,83,919,328,242,1489,40,66,131,237,1726,-5.684595032,122.4923625
KAPONTORI,110,671,208,82,961,32,45,94,171,1132,-5.241842924,122.8104907
GU,120,1085,389,188,1662,169,116,202,487,2149,-5.268045783,122.5921872
SANGIA WAMBULU,121,385,166,90,641,12,18,51,81,722,-5.354699839,122.6281698
LAKUDO,130,1959,630,338,2927,131,133,261,525,3452,-5.319826433,122.5377107
MAWASANGKA,140,1383,394,216,1993,225,133,213,571,2564,-5.26656693,122.3350894
MAWASANGKA TIMUR,141,321,90,40,451,34,27,39,100,551,-5.355712367,122.4405941
MAWASANGKA TENGAH,142,719,287,172,1178,33,43,106,182,1360,-5.312685785,122.38771
TALAGA RAYA,151,647,228,141,1016,46,48,85,179,1195,-5.447358305,122.0035899
TONGKUNO,10,1215,446,209,1870,74,74,173,321,2191,-5.050134501,122.6108574
TONGKUNO SELATAN,11,484,159,74,717,27,22,42,91,808,-5.184567123,122.5163117
PARIGI,20,1089,434,215,1738,77,69,135,281,2019,-5.075502126,122.457421
BONE,21,510,159,91,760,29,14,64,107,867,-5.172278432,122.4363443
MAROBO,22,790,192,67,1049,46,100,155,301,1350,-5.126451845,122.3536712
KABAWO,30,1116,490,249,1855,81,84,176,341,2196,-5.006734961,122.4871202
KABANGKA,31,575,260,155,990,30,33,61,124,1114,-4.955191723,122.4174997
KONTUKOWUNA,32,440,180,80,700,20,21,89,130,830,-4.945589308,122.4988021
TIWORO KEPULAUAN,40,421,151,74,646,27,36,66,129,775,-4.779584569,122.4352647
MAGINTI,41,582,167,56,805,64,79,156,299,1104,-4.873030365,122.3430068
TIWORO TENGAH,42,302,121,38,461,23,42,67,132,593,-4.805663773,122.3767423
TIWORO SELATAN,43,346,154,89,589,27,29,59,115,704,-4.880632596,122.3974293
TIWORO UTARA,44,456,107,46,609,45,87,113,245,854,-4.684677816,122.3508652
LAWA,50,666,256,153,1075,62,36,87,185,1260,-4.891368392,122.5897589
SAWERIGADI,51,683,286,162,1131,41,37,94,172,1303,-4.80412484,122.4924859
BARANGKA,52,454,219,125,798,24,41,98,163,961,-4.825031164,122.5522236
WA DAGA,53,587,231,111,929,51,36,40,127,1056,-4.912751173,122.5100144
KUSAMBI,60,717,333,187,1237,80,71,101,252,1489,-4.741238713,122.5458521
KONTUNAGA,61,720,298,153,1171,37,63,107,207,1378,-4.84867997,122.6500267
WATOPUTE,62,717,336,186,1239,33,64,109,206,1445,-4.792661898,122.6332796
KATOBU,70,485,208,120,813,10,18,66,94,907,-4.828075989,122.7139863
LOHIA,71,1132,414,202,1748,103,137,251,491,2239,-4.902867012,122.7171496
DURUKA,72,776,295,158,1229,70,52,133,255,1484,-4.863362214,122.7161585
BATALAIWORU,73,399,146,89,634,2,13,60,75,709,-4.798136882,122.705374
NAPABALANO,80,769,278,149,1196,63,59,136,258,1454,-4.656043153,122.6793143
LASALEPA,81,688,231,136,1055,29,75,121,225,1280,-4.736970126,122.6959281
NAPANO KUSAMBI,82,441,194,86,721,22,42,90,154,875,-4.697461216,122.6063737
TOWEA,83,350,110,40,500,75,72,100,247,747,-4.547818844,122.7136405
WAKORUMBA SELATAN,90,364,158,71,593,18,17,38,73,666,-4.927142904,122.8625322
PASIR PUTIH,91,349,144,53,546,17,16,49,82,628,-5.032812358,122.8302425
PASI KOLAGA,92,281,110,50,441,18,18,32,68,509,-5.008750597,122.8068179
MALIGANO,111,470,196,91,757,43,30,54,127,884,-4.676378667,122.8818375
BATUKARA,112,194,59,25,278,10,13,18,41,319,-4.821185548,122.8764044
WAWONII SELATAN,71,414,125,98,637,21,27,79,127,764,-4.169243495,123.0458764
WAWONII BARAT,72,462,167,87,716,38,38,83,159,875,-4.042304146,123.0237896
WAWONII TENGAH,73,356,120,75,551,6,13,76,95,646,-4.103095821,122.9871043
WAWONII TENGGARA,74,787,261,105,1153,25,48,116,189,1342,-4.18392581,123.1367867
WAWONII TIMUR,81,308,116,60,484,4,17,37,58,542,-4.103539346,123.1974329
WAWONII UTARA,82,554,182,98,834,24,20,112,156,990,-4.055139614,123.1180568
WAWONII TIMUR LAUT,83,352,76,26,454,6,5,31,42,496,-4.049303726,123.2047657
SOROPIA,90,530,121,48,699,46,71,128,245,944,-3.915056634,122.6261315
LALONGGASUMEETO,91,192,66,23,281,3,10,35,48,329,-3.911578014,122.5282289
SAMPARA,100,570,159,68,797,37,50,136,223,1020,-3.976047053,122.4090011
BONDOALA,101,555,177,80,812,26,62,149,237,1049,-3.899735287,122.4108487
BESULUTU,102,441,155,72,668,16,40,101,157,825,-3.965093237,122.3290933
KAPOIALA,103,276,106,40,422,12,19,49,80,502,-3.857952747,122.4795204
LAMBUYA,130,369,114,47,530,33,41,92,166,696,-3.966123338,122.0421312
UEPAI,131,663,194,87,944,31,68,139,238,1182,-3.870262505,121.9839869
PURIALA,132,545,175,86,806,28,56,116,200,1006,-4.049681447,122.1078168
ONEMBUTE,133,371,115,56,542,35,37,87,159,701,-4.050968344,122.0100847
PONDIDAHA,140,681,200,93,974,43,54,139,236,1210,-3.964228806,122.2496074
WONGGEDUKU,141,1155,319,162,1636,64,96,232,392,2028,-3.954545759,122.1645253
AMONGGEDO,142,556,189,70,815,21,32,112,165,980,-3.888559368,122.2528701
WAWOTOBI,150,787,265,126,1178,41,59,164,264,1442,-3.861669576,122.1393476
MELUHU,151,302,88,48,438,10,20,42,72,510,-3.800827556,122.2171913
KONAWE,152,472,160,78,710,25,31,97,153,863,-3.909467542,122.1008985
UNAAHA,170,303,112,51,466,14,24,61,99,565,-3.857311268,122.0573532
ANGGABERI,171,220,76,39,335,9,14,46,69,404,-3.776383906,122.1018381
ABUKI,180,980,302,120,1402,60,84,225,369,1771,-3.676955524,121.9444101
LATOMA,181,322,50,9,381,31,38,74,143,524,-3.576704083,121.6566419
TONGAUNA,182,846,236,83,1165,50,88,192,330,1495,-3.767431351,122.0178108
ASINUA,183,261,55,21,337,17,37,80,134,471,-3.657960455,121.8258373
ROUTA,193,221,51,10,282,14,23,42,79,361,-3.070316263,121.6829819
WATUBANGGA,10,888,298,144,1330,33,70,213,316,1646,-4.487954514,121.642228
TANGGETADA,11,660,223,124,1007,36,50,120,206,1213,-4.344597563,121.6440486
TOARI,12,720,244,105,1069,33,69,180,282,1351,-4.559150811,121.5291465
POLINGGONA,13,374,143,62,579,21,25,74,120,699,-4.424148652,121.6462368
POMALAA,20,709,213,87,1009,79,75,190,344,1353,-4.241476428,121.649057
WUNDULAKO,30,830,279,125,1234,65,87,185,337,1571,-4.106116838,121.6306076
BAULA,31,496,157,67,720,35,62,118,215,935,-4.163386383,121.7093654
LADONGI,40,1131,326,140,1597,61,126,266,453,2050,-4.160314117,121.9165256
LAMBADIA,41,1227,381,184,1792,123,203,354,680,2472,-4.309516413,121.8835624
POLI-POLIA,42,548,163,74,785,22,46,125,193,978,-4.204943058,121.8480513
TIRAWUTA,50,1082,376,195,1653,26,69,190,285,1938,-3.990922229,121.9046606
LALOLAE,51,340,98,41,479,13,39,70,122,601,-4.027026034,121.7943208
LOEA,52,509,159,65,733,41,63,103,207,940,-4.089395775,121.8732787
KOLAKA,60,810,240,85,1135,76,73,188,337,1472,-4.037750288,121.6632371
LATAMBAGA,61,1336,367,127,1830,109,155,325,589,2419,-3.960634278,121.5859451
WOLO,70,1735,523,222,2480,168,152,330,650,3130,-3.766972379,121.324716
SAMATURU,71,1307,367,182,1856,256,193,303,752,2608,-3.900832859,121.4644432
MOWEWE,80,394,148,54,596,106,65,110,281,877,-3.949316782,121.7134653
ULUIWOI,81,733,211,122,1066,66,80,193,339,1405,-3.5471073,121.3907116
TINONDO,82,547,183,59,789,50,82,136,268,1057,-3.863446302,121.8168497
TINANGGEA,10,1098,304,109,1511,91,143,287,521,2032,-4.448077491,122.1881514
LALEMBUU,11,723,222,104,1049,25,74,138,237,1286,-4.387927541,122.059303
ANDOOLO,20,922,292,111,1325,27,73,198,298,1623,-4.333639455,122.2084023
BUKE,21,741,237,87,1065,60,65,185,310,1375,-4.237828001,122.2369361
PALANGGA,30,654,193,82,929,21,51,149,221,1150,-4.337746387,122.3651642
PALANGGA SELATAN,31,457,112,41,610,43,38,105,186,796,-4.419347122,122.3829554
BAITO,32,546,164,71,781,25,76,151,252,1033,-4.238436427,122.3392122
LAINEA,40,462,124,57,643,32,49,106,187,830,-4.402447528,122.6182187
LAEYA,41,1061,263,134,1458,67,92,221,380,1838,-4.323673591,122.4810139
KOLONO,50,963,238,107,1308,40,79,183,302,1610,-4.334283918,122.7239594
LAONTI,60,857,247,112,1216,36,87,214,337,1553,-4.21574558,122.8366033
MORAMO,70,832,248,97,1177,45,66,170,281,1458,-4.198491229,122.6536344
MORAMO UTARA,71,358,103,48,509,28,33,55,116,625,-4.105838571,122.5982419
KONDA,80,562,166,70,798,54,83,129,266,1064,-4.112081519,122.4700422
WOLASI,81,267,95,34,396,15,31,55,101,497,-4.195019469,122.4713203
RANOMEETO,90,349,73,32,454,9,34,72,115,569,-4.083934912,122.4018586
RANOMEETO BARAT,91,241,73,27,341,21,19,72,112,453,-4.040672409,122.3768131
LANDONO,100,568,176,58,802,41,48,117,206,1008,-4.077055289,122.2924516
MOWILA,101,562,131,39,732,45,63,146,254,986,-4.108164822,122.2322432
ANGATA,110,1037,440,214,1691,165,120,255,540,2231,-4.15624872,122.1172607
BENUA,111,655,209,109,973,70,105,160,335,1308,-4.247568956,122.0946978
BASALA,112,290,104,32,426,19,36,93,148,574,-4.316205123,122.049511
KABAENA,10,188,63,34,285,4,6,26,36,321,-5.278697036,121.8840784
KABAENA UTARA,11,324,86,32,442,17,24,67,108,550,-5.149266384,121.8888085
KABAENA SELATAN,12,161,60,35,256,32,15,27,74,330,-5.356622724,121.8973735
KABAENA BARAT,13,587,203,85,875,75,69,133,277,1152,-5.200905058,121.8365371
KABAENA TIMUR,20,561,196,105,862,46,42,77,165,1027,-5.282618278,122.0299678
KABAENA TENGAH,21,263,79,41,383,9,10,37,56,439,-5.232269641,121.9661193
RUMBIA,30,257,90,51,398,26,25,55,106,504,-4.758032519,122.0101059
MATA OLEO,31,610,155,55,820,57,86,153,296,1116,-4.845541466,122.013907
KEP. MASALOKA RAYA,32,297,67,34,398,29,38,67,134,532,-4.824209367,122.1320382
RUMBIA TENGAH,33,228,56,41,325,17,23,44,84,409,-4.799401676,122.0655695
RAROWATU,40,323,122,55,500,13,19,54,86,586,-4.721712539,121.8981166
RAROWATU UTARA,41,187,76,32,295,17,23,38,78,373,-4.64159919,121.9391182
MATA USU,42,46,11,2,59,10,7,5,22,81,-4.49866663,121.8439565
LANTARI JAYA,43,621,184,44,849,24,73,152,249,1098,-4.541600118,121.9896702
POLEANG TIMUR,50,410,142,43,595,51,42,65,158,753,-4.802442028,121.8046884
POLEANG UTARA,51,500,173,52,725,37,51,110,198,923,-4.712519737,121.7798756
POLEANG SELATAN,52,300,91,39,430,19,52,82,153,583,-4.802521319,121.6878926
POLEANG TENGGARA,53,306,77,37,420,81,58,91,230,650,-4.830899395,121.916071
POLEANG,60,550,200,89,839,103,112,140,355,1194,-4.72083273,121.6040925
POLEANG BARAT,61,590,208,87,885,74,90,181,345,1230,-4.633372801,121.5740137
TONTONUNU,62,243,101,31,375,37,30,70,137,512,-4.64660234,121.7108256
POLEANG TENGAH,63,145,74,30,249,7,16,24,47,296,-4.740360285,121.6392728
BINONGKO,10,584,258,160,1002,4,12,75,91,1093,-5.945321433,124.0524454
TOGO BINONGKO,11,290,130,54,474,1,13,47,61,535,-5.971262008,124.029286
TOMIA,20,383,156,78,617,36,18,39,93,710,-5.659377388,124.017744
TOMIA TIMUR,21,334,124,105,563,3,10,37,50,613,-5.765134238,123.956398
KALEDUPA,30,760,311,157,1228,86,63,67,216,1444,-5.50677973,123.7423844
KALEDUPA SELATAN,31,357,200,110,667,15,12,41,68,735,-5.567838921,123.8191587
WANGI-WANGI,40,1327,519,315,2161,66,93,199,358,2519,-5.283699834,123.5739779
WANGI-WANGI SELATAN,50,1904,825,445,3174,267,204,425,896,4070,-5.3537525,123.5851083
RANTEANGIN,10,382,131,50,563,20,33,66,119,682,-3.613185146,121.0703575
LAMBAI,11,390,103,53,546,18,16,62,96,642,-3.581835372,121.0507359
WAWO,12,447,144,67,658,35,31,85,151,809,-3.649579454,121.1440685
LASUSUA,20,1308,389,142,1839,152,144,256,552,2391,-3.529550092,120.9847203
KATOI,21,540,127,95,762,31,43,101,175,937,-3.45446454,120.9785441
KODEOHA,30,525,167,82,774,41,52,110,203,977,-3.40913059,121.0049075
TIWU,31,252,80,19,351,9,31,67,107,458,-3.383135466,121.0397803
NGAPA,40,557,120,30,707,172,147,188,507,1214,-3.340855464,121.0727115
WATUNOHU,41,370,97,35,502,26,36,61,123,625,-3.282903695,120.9907144
PAKUE,50,757,243,112,1112,24,54,124,202,1314,-3.259131076,121.099444
PAKUE UTARA,51,487,131,64,682,39,38,94,171,853,-3.245901446,121.3168158
PAKUE TENGAH,52,631,218,104,953,56,60,115,231,1184,-3.19480519,121.14834
BATU PUTIH,60,826,269,135,1230,54,78,151,283,1513,-3.11601641,121.2615769
POREHU,61,678,156,44,878,53,66,94,213,1091,-2.971189552,121.2560629
TOLALA,62,319,81,27,427,13,24,66,103,530,-2.879157698,121.1181849
BONEGUNU,100,560,223,142,925,25,27,64,116,1041,-4.796092856,122.9970176
KAMBOWA,101,513,219,167,899,15,26,64,105,1004,-5.038988824,122.9176189
WAKORUMBA,110,563,229,130,922,30,30,75,135,1057,-4.518801502,122.9315554
KULISUSU,120,1163,435,283,1881,87,99,221,407,2288,-4.751933722,123.1689589
KULISUSU BARAT,121,555,222,108,885,19,36,116,171,1056,-4.644655788,123.0137069
KULISUSU UTARA,122,553,205,100,858,18,33,98,149,1007,-4.544166844,123.0884219
SAWA,10,229,72,31,332,12,9,36,57,389,-3.814890343,122.3979088
MOTUI,11,232,57,39,328,13,16,55,84,412,,
LEMBO,20,249,68,41,358,6,7,38,51,409,-3.78297706,122.3265149
LASOLO,30,713,208,73,994,23,43,111,177,1171,-3.575688818,122.2389639
MOLAWE,40,321,111,55,487,32,19,53,104,591,-3.566513529,122.2039864
ASERA,50,440,134,86,660,17,24,83,124,784,-3.397827751,121.8376613
ANDOWIA,51,319,92,44,455,11,14,55,80,535,,
OHEO,52,283,90,48,421,8,20,57,85,506,,
LANGGIKIMA,60,144,46,22,212,14,15,25,54,266,-3.315596233,122.2387465
WIWIRANO,70,459,152,94,705,24,25,57,106,811,-3.186282407,122.0669002
MANDONGA,10,840,263,117,1220,52,74,140,266,1486,-3.937719675,122.5047827
BARUGA,11,417,155,83,655,24,40,82,146,801,-4.043386578,122.5013797
PUUWATU,12,1106,423,229,1758,70,69,252,391,2149,-3.966014205,122.4714917
KADIA,13,426,135,91,652,25,16,62,103,755,-3.98396861,122.507768
WUA-WUA,14,710,246,134,1090,39,49,110,198,1288,-3.998935791,122.4920686
POASIA,20,923,299,193,1415,60,61,136,257,1672,-4.034871313,122.564582
ABELI,21,1366,410,232,2008,87,116,265,468,2476,-4.012914789,122.6000991
KAMBU,22,279,71,46,396,22,19,32,73,469,-4.02408545,122.5318787
KENDARI,30,1057,334,217,1608,77,70,167,314,1922,-3.957576441,122.5982616
KENDARI BARAT,31,1094,310,149,1553,74,81,203,358,1911,-3.954182118,122.5512248
BETOAMBARI,10,1028,332,224,1584,46,59,169,274,1858,-5.505052027,122.5853553
MURHUM,11,1472,449,277,2198,52,75,206,333,2531,-5.475947218,122.5994561
WOLIO,20,1611,430,223,2264,36,81,205,322,2586,-5.484082439,122.6374329
KOKALUKUNA,21,1127,347,173,1647,38,48,173,259,1906,-5.437219655,122.6522936
SORAWOLIO,30,858,318,203,1379,26,30,93,149,1528,-5.437775387,122.7172647
BUNGI,40,560,194,114,868,30,34,94,158,1026,-5.372106706,122.6933543
LEA-LEA,41,726,229,117,1072,27,61,135,223,1295,-5.368687345,122.653528
MANANGGU,31,874,301,147,1322,55,91,197,343,1665,0.691502083,122.1457952
TILAMUTA,40,1554,495,304,2353,153,180,339,672,3025,0.587224201,122.3204157
DULUPI,41,1408,461,225,2094,190,203,337,730,2824,0.6293424,122.3828407
BOTUMOITO,42,1079,364,226,1669,126,108,207,441,2110,0.693540955,122.218406
PAGUYAMAN,50,1783,519,293,2595,311,286,433,1030,3625,0.620711389,122.5448127
WONOSARI,51,1499,433,292,2224,212,204,361,777,3001,0.713788893,122.4185825
PAGUYAMAN PANTAI,52,857,278,152,1287,74,92,175,341,1628,0.539629862,122.5701239
BATUDAA PANTAI,10,1033,365,211,1609,106,127,255,488,2097,0.50634904,122.9545695
BILUHU,11,772,301,138,1211,77,81,170,328,1539,0.507262606,122.778074
BATUDAA,20,814,290,145,1249,80,108,184,372,1621,0.538856786,122.9678869
BONGOMEME,21,2904,977,485,4366,411,584,968,1963,6329,0.569691167,122.8095539
TABONGO,22,1187,412,190,1789,208,240,372,820,2609,0.57126423,122.9225023
TIBAWA,30,2894,872,400,4166,411,719,1114,2244,6410,0.69364606,122.8520011
PULUBALA,31,2125,665,328,3118,245,389,783,1417,4535,0.680241122,122.7504019
BOLIYOHUTO,40,1132,382,254,1768,49,109,236,394,2162,0.600559715,122.6518026
MOOTILANGO,41,1771,578,377,2726,171,285,542,998,3724,0.757799987,122.6498832
TOLANGOHULA,42,1633,554,366,2553,124,190,415,729,3282,0.780186462,122.5570267
ASPARAGA,43,1039,327,229,1595,237,217,342,796,2391,0.83613831,122.3879706
BILATO,44,919,283,139,1341,101,157,296,554,1895,,
LIMBOTO,70,1800,581,330,2711,287,388,587,1262,3973,,
LIMBOTO BARAT,71,1515,505,270,2290,183,236,410,829,3119,0.65910028,122.9269694
TELAGA,80,1050,334,166,1550,130,148,230,508,2058,0.659898509,123.0410807
TELAGA BIRU,81,1641,524,283,2448,190,284,464,938,3386,0.698188732,123.0421112
TILANGO,82,592,151,64,807,181,155,231,567,1374,0.561483824,123.0230285
TELAGA JAYA,83,439,128,68,635,69,90,134,293,928,0.580608868,123.0230504
POPAYATO,10,430,123,60,613,93,105,127,325,938,0.650918961,121.4394709
POPAYATO BARAT,11,394,133,66,593,92,78,110,280,873,0.670348033,121.3236726
POPAYATO TIMUR,12,393,134,85,612,64,68,116,248,860,0.680087188,121.485198
LEMITO,20,665,221,158,1044,91,99,162,352,1396,0.705169264,121.5801201
WANGGARASI,21,345,108,65,518,16,32,65,113,631,0.696216184,121.6910516
MARISA,30,455,192,100,747,57,50,114,221,968,0.473116276,121.9575451
PATILANGGIO,31,608,216,128,952,69,66,130,265,1217,0.67783827,121.8993659
BUNTULIA,32,530,204,115,849,38,64,143,245,1094,0.699116495,121.9848761
DUHIADAA,33,556,167,125,848,62,77,161,300,1148,0.472326541,121.9023658
RANDANGAN,40,519,224,149,892,59,61,133,253,1145,0.514162109,121.7933916
TALUDITI,41,397,143,57,597,14,47,103,164,761,0.78203493,121.8136378
PAGUAT,50,668,281,165,1114,51,97,161,309,1423,0.497295625,122.0551183
DENGILO,51,384,170,98,652,40,36,80,156,808,0.69137966,122.0782657
TAPA,10,290,102,40,432,20,27,75,122,554,0.623652951,123.0993379
BULANGO UTARA,11,496,192,87,775,21,45,109,175,950,0.71236808,123.0910691
BULANGO SELATAN,12,359,111,61,531,17,28,82,127,658,0.592565813,123.0769293
BULANGO TIMUR,13,176,55,28,259,8,9,38,55,314,0.610072394,123.1076684
BULANGO ULU,14,407,120,61,588,36,47,107,190,778,0.687114544,123.1953644
KABILA,20,384,124,57,565,13,28,83,124,689,0.545077958,123.1033988
BOTU PINGGE,21,240,97,53,390,7,21,57,85,475,0.518528452,123.1022322
TILONGKABILA,22,792,226,118,1136,42,66,152,260,1396,0.589897844,123.1325816
SUWAWA,30,487,203,95,785,12,34,121,167,952,0.57958554,123.1809397
SUWAWA SELATAN,31,368,118,62,548,34,58,120,212,760,0.497849168,123.1757692
SUWAWA TIMUR,32,428,127,85,640,59,81,128,268,908,0.535023558,123.3725631
SUWAWA TENGAH,33,272,92,51,415,1,20,62,83,498,0.540955633,123.1839968
BONEPANTAI,40,751,281,136,1168,56,70,124,250,1418,0.414574673,123.2286001
KABILA BONE,41,670,212,109,991,41,85,156,282,1273,0.460060683,123.1422244
BONE RAYA,42,290,131,69,490,73,22,59,154,644,0.358366791,123.3534394
BONE,43,875,263,164,1302,49,105,202,356,1658,0.375589699,123.4449585
BULAWA,44,258,104,43,405,14,22,62,98,503,0.371353603,123.2959283
ATINGGOLA,10,743,217,123,1083,39,62,140,241,1324,0.828837355,123.1466487
GENTUMA RAYA,11,604,158,92,854,33,58,101,192,1046,0.866242283,123.0251794
KWANDANG,20,2595,751,406,3752,249,373,628,1250,5002,0.819407587,122.9380104
ANGGREK,30,1814,531,272,2617,219,310,472,1001,3618,0.844340051,122.726362
SUMALATA,40,1208,291,142,1641,78,101,188,367,2008,0.944696122,122.4406072
TOLINGGULA,50,895,220,122,1237,65,59,124,248,1485,0.956169232,122.134363
KOTA BARAT,10,927,317,155,1399,66,106,204,376,1775,0.539989938,123.025685
DUNGINGI,11,617,212,127,956,23,28,109,160,1116,0.560512325,123.0395727
KOTA SELATAN,20,352,118,61,531,21,20,45,86,617,0.524050751,123.0507607
KOTA TIMUR,21,482,155,99,736,20,41,98,159,895,0.516886962,123.0764592
HULONTHALANGI,22,414,161,57,632,18,32,105,155,787,,
DUMBO RAYA,23,486,192,77,755,21,38,110,169,924,,
KOTA UTARA,30,685,229,126,1040,31,68,142,241,1281,0.569671328,123.0732709
KOTA TENGAH,31,541,181,77,799,24,45,94,163,962,0.562677871,123.0551078
SIPATANA,32,466,165,88,719,33,60,111,204,923,,
BANGGAE,10,1135,380,193,1708,123,178,297,598,2306,-3.537601754,118.9446126
BANGGAE TIMUR,11,704,248,150,1102,45,69,164,278,1380,-3.511447717,118.9673513
PAMBOANG,20,1503,600,261,2364,89,153,290,532,2896,-3.466632461,118.9107203
SENDANA,30,1081,439,252,1772,81,104,196,381,2153,-3.339431453,118.8832657
TAMMERODO,31,717,264,137,1118,79,53,128,260,1378,-3.227035173,118.8645722
TUBO SENDANA,33,426,156,93,675,38,40,88,166,841,-3.130915264,118.8217795
MALUNDA,40,1208,425,212,1845,92,88,175,355,2200,-2.980041607,118.9435038
ULUMANDA,41,893,302,132,1327,72,80,142,294,1621,-3.085284034,118.9435644
TINAMBUNG,10,1796,644,362,2802,130,183,369,682,3484,-3.506107441,119.011999
BALANIPA,11,2063,710,343,3116,198,310,471,979,4095,-3.48497334,119.0644584
LIMBORO,12,1500,444,242,2186,137,230,333,700,2886,-3.451023629,119.0151396
TUBBI TARAMANU,20,2288,822,468,3578,641,385,535,1561,5139,-3.219191984,119.0059925
ALU,21,1256,358,201,1815,121,155,217,493,2308,-3.368949765,118.9660575
CAMPALAGIAN,30,3688,1110,547,5345,447,652,894,1993,7338,-3.453766887,119.1262475
LUYO,31,2675,877,442,3994,335,352,495,1182,5176,-3.365516044,119.1071578
WONOMULYO,40,1705,615,265,2585,106,184,325,615,3200,-3.424303547,119.2358009
MAPILLI,41,2171,768,378,3317,167,284,457,908,4225,-3.365713426,119.1745558
TAPANGO,42,1483,474,207,2164,171,194,327,692,2856,-3.312187304,119.2532549
MATAKALI,43,1631,595,313,2539,164,218,330,712,3251,-3.359875161,119.2905783
B U L O,44,1182,377,180,1739,131,153,212,496,2235,-3.203848209,119.128691
POLEWALI,50,2394,800,353,3547,243,308,480,1031,4578,-3.412892715,119.3264821
BINUANG,51,2382,941,471,3794,199,244,461,904,4698,-3.425653799,119.4215846
ANREAPI,52,825,283,154,1262,105,129,166,400,1662,-3.347936744,119.3733554
MATANGNGA,61,588,163,37,788,39,75,136,250,1038,-3.189468941,119.2253545
SUMARORONG,10,845,265,123,1233,28,42,66,136,1369,-3.142756382,119.3317744
MESSAWA,20,470,120,28,618,22,31,41,94,712,-3.257371026,119.3661119
PANA,30,1174,289,47,1510,48,43,60,151,1661,-3.056008043,119.5367705
NOSU,31,429,149,48,626,13,9,19,41,667,-3.131497629,119.4799718
TABANG,40,894,269,140,1303,85,107,162,354,1657,-2.859564742,119.5233004
MAMASA,50,1036,370,157,1563,126,108,186,420,1983,-2.879166465,119.4070955
TANDUK KALUA,60,854,320,182,1356,117,101,150,368,1724,-3.05306222,119.310037
BALLA,61,297,85,51,433,21,20,46,87,520,-2.991398578,119.3166309
SESENAPADANG,70,770,326,160,1256,35,28,67,130,1386,-3.033259194,119.4155943
TAWALIAN,71,608,174,89,871,38,38,71,147,1018,-2.95218331,119.416573
MAMBI,80,812,252,164,1228,32,38,80,150,1378,-3.001941178,119.1290954
BAMBANG,81,1186,461,205,1852,122,93,112,327,2179,-2.913977891,119.2514875
RANTEBULAHAN TIMUR,82,705,256,113,1074,60,33,69,162,1236,-2.984459627,119.2257805
MEHALAAN,83,272,86,50,408,7,9,20,36,444,-3.057636273,119.178845
ARALLE,90,875,351,193,1419,31,40,110,181,1600,-2.875160923,119.0799633
BUNTU MALANGKA,91,644,219,123,986,29,20,63,112,1098,-2.839442292,119.1930999
TABULAHAN,100,1098,370,145,1613,63,68,132,263,1876,-2.765284109,119.222781
TAPALANG,10,868,230,122,1220,70,61,115,246,1466,-2.855423658,118.9435957
TAPALANG BARAT,11,378,98,45,521,25,30,67,122,643,-2.777115694,118.7985908
MAMUJU,20,609,141,57,807,236,138,197,571,1378,-2.720387439,118.9429441
SIMBORO,22,626,185,83,894,239,96,157,492,1386,-2.716560707,118.8463511
BALABALAKANG,23,27,5,0,32,4,7,9,20,52,-2.055765254,117.2660087
KALUKKU,30,1337,315,125,1777,212,216,279,707,2484,-2.593474055,119.0951801
PAPALANG,31,519,123,38,680,57,68,103,228,908,-2.430057156,119.2043319
SAMPAGA,32,184,35,19,238,20,35,55,110,348,-2.358478306,119.2236041
TOMMO,33,645,165,61,871,42,55,114,211,1082,-2.262188361,119.4432
KALUMPANG,40,910,254,123,1287,101,104,172,377,1664,-2.530755828,119.5858821
BONEHAU,41,549,148,75,772,16,37,61,114,886,-2.591595982,119.3437984
BUDONG-BUDONG,50,474,99,51,624,90,72,78,240,864,-2.166741566,119.2486264
PANGALE,51,255,81,24,360,11,15,36,62,422,-2.254737504,119.1882193
TOPOYO,52,437,89,30,556,61,51,81,193,749,-2.029886983,119.581064
KAROSSA,53,763,175,66,1004,77,89,134,300,1304,-1.883290411,119.5704382
TOBADAK,54,447,98,36,581,43,44,72,159,740,-2.11837165,119.4875858
SARUDU,10,554,181,89,824,31,37,67,135,959,-1.679110925,119.3299575
DAPURANG,11,765,170,59,994,66,79,132,277,1271,-1.733906071,119.6007237
DURIPOKU,12,158,43,17,218,3,9,14,26,244,-1.637379095,119.4848069
BARAS,20,559,170,91,820,54,71,109,234,1054,-1.568786851,119.3908963
BULU TABA,21,327,95,36,458,36,39,72,147,605,-1.51476985,119.5670336
LARIANG,22,396,101,51,548,31,33,65,129,677,-1.466033162,119.3395752
PASANGKAYU,30,848,259,112,1219,83,114,159,356,1575,-1.20208915,119.4504321
TIKKE RAYA,31,676,181,87,944,51,93,130,274,1218,-1.365810736,119.3868511
PEDONGGA,32,213,71,22,306,45,24,62,131,437,-1.273783546,119.3973196
BAMBALAMOTU,40,1484,395,179,2058,114,155,264,533,2591,-1.098242221,119.5108278
BAMBAIRA,41,755,176,104,1035,60,69,115,244,1279,-0.989871548,119.524065
SARJO,42,491,141,76,708,33,44,79,156,864,-0.90502201,119.5458267
TANIMBAR SELATAN,40,1493,539,264,2296,46,70,177,293,2589,-7.926661862,131.2323085
WER TAMRIAN,41,1213,425,206,1844,49,49,160,258,2102,-7.742690545,131.3816931
WER MAKTIAN,42,1135,425,163,1723,34,48,145,227,1950,-7.639813852,131.136383
SELARU,43,1388,432,115,1935,42,60,109,211,2146,-8.186849723,130.9735866
TANIMBAR UTARA,50,1089,359,130,1578,48,24,77,149,1727,-7.193894848,131.740053
YARU,51,600,169,71,840,13,13,44,70,910,-7.036378848,131.9452219
WUAR LABOBAR,52,959,330,160,1449,31,37,164,232,1681,-7.339968311,131.4407592
NIRUNMAS,53,882,341,110,1333,15,34,117,166,1499,-7.457906088,131.5875212
KORMOMOLIN,54,714,241,71,1026,14,24,76,114,1140,-7.612365005,131.5260247
MOLU MARU,55,298,51,5,354,16,32,40,88,442,,
KEI KECIL,10,2500,1014,614,4128,95,120,341,556,4684,-5.723562543,132.7047189
KEI KECIL BARAT,12,600,167,73,840,16,36,88,140,980,-5.890868688,132.6265183
KEI KECIL TIMUR,13,1196,416,234,1846,34,32,140,206,2052,-5.867369196,132.7690781
KEI BESAR,20,2857,1026,513,4396,109,144,436,689,5085,-5.53052487,133.0482255
KEI BESAR UTARA TIMUR,21,1377,498,204,2079,65,101,254,420,2499,-5.436428244,133.1221943
KEI BESAR SELATAN,22,949,269,93,1311,27,68,106,201,1512,-5.863510491,132.911716
BANDA,10,1004,311,167,1482,33,55,150,238,1720,-4.546056027,129.8935584
TEHORU,40,1990,696,400,3086,86,94,225,405,3491,-3.290434518,129.551489
TELUTIH,41,1086,485,289,1860,52,49,104,205,2065,,
AMAHAI,50,3499,1385,775,5659,176,201,573,950,6609,-3.218762552,129.1540604
KOTA MASOHI,51,787,316,219,1322,27,23,75,125,1447,-3.304705784,128.9585787
TELUK ELPAPUTIH,52,522,194,129,845,16,14,60,90,935,-3.139348686,128.8174297
TEON NILA SERUA,60,1287,575,322,2184,33,26,150,209,2393,-3.210058867,129.0139893
SAPARUA,80,2867,1037,538,4442,71,107,369,547,4989,-3.554853833,128.6541351
NUSALAUT,81,570,197,105,872,8,8,56,72,944,-3.668535985,128.7835862
P. HARUKU,90,2179,901,581,3661,51,69,275,395,4056,-3.571760278,128.4834273
SALAHUTU,100,1939,894,520,3353,59,96,326,481,3834,-3.559584847,128.2991626
LEIHITU,110,3103,1336,829,5268,151,155,520,826,6094,-3.611019161,128.0726104
LEIHITU BARAT,111,1219,406,255,1880,9,40,137,186,2066,-3.691060693,127.9853353
SERAM UTARA,140,1287,529,261,2077,63,73,209,345,2422,-3.019326274,129.6221775
SERAM UTARA BARAT,141,981,380,258,1619,35,31,116,182,1801,-2.938805285,128.9361599
SERAM UTARA TIMUR KOBI,142,825,320,211,1356,204,63,172,439,1795,,
SERAM UTARA TIMUR SETI,143,724,255,153,1132,177,73,146,396,1528,,
NAMLEA,20,2029,791,472,3292,99,98,268,465,3757,-3.215592187,126.9828955
WAEAPO,21,2019,749,404,3172,545,262,473,1280,4452,-3.393443256,126.8821897
WAPLAU,22,1229,464,260,1953,47,54,195,296,2249,-3.161984833,126.7618062
BATA BUAL,23,1244,508,309,2061,13,22,123,158,2219,-3.491258357,127.1804121
AIR BUAYA,30,2266,676,302,3244,596,295,407,1298,4542,-3.246924142,126.4297133
ARU SELATAN,10,1098,270,84,1452,58,69,144,271,1723,-6.541692829,134.2041171
ARU SELATAN TIMUR,11,669,171,47,887,21,52,92,165,1052,-6.632473452,134.3407184
ARU TENGAH,20,1316,253,61,1630,50,124,251,425,2055,-6.205024571,134.4451317
ARU TENGAH TIMUR,21,435,158,80,673,55,39,83,177,850,-6.101750938,134.6486114
ARU TENGAH SELATAN,22,578,170,86,834,36,54,97,187,1021,-6.569689738,134.7495705
PULAU-PULAU ARU,30,1679,685,414,2778,73,122,257,452,3230,-5.755717869,134.3961589
ARU UTARA,31,1575,422,117,2114,60,161,275,496,2610,-5.640315297,134.618731
HUAMUAL BELAKANG,10,3830,1351,515,5696,110,162,378,650,6346,-3.170036677,127.8332473
KEPULAUAN MANIPA,11,682,198,106,986,27,22,45,94,1080,,
SERAM BARAT,20,1985,806,347,3138,32,60,219,311,3449,-3.110730388,128.1592794
HUAMUAL,21,4880,1722,781,7383,145,265,738,1148,8531,,
KAIRATU,30,1232,489,269,1990,24,43,154,221,2211,-3.267502065,128.5039749
KAIRATU BARAT,31,740,279,155,1174,21,42,109,172,1346,,
INAMOSOL,32,527,147,47,721,23,57,97,177,898,,
AMALATU,33,1001,319,148,1468,17,21,103,141,1609,,
ELPAPUTIH,34,420,150,70,640,15,8,33,56,696,,
TANIWEL,40,1379,458,211,2048,24,46,125,195,2243,-2.958348201,128.513736
TANIWEL TIMUR,41,513,161,100,774,6,8,35,49,823,,
PULAU GOROM,10,2876,1236,631,4743,199,124,345,668,5411,-4.047962853,131.3499838
WAKATE,11,1060,319,151,1530,67,53,107,227,1757,-4.580063536,131.6846377
SERAM TIMUR,20,2007,784,378,3169,96,89,212,397,3566,-3.663772663,130.6294971
TUTUK TOLU,21,638,267,115,1020,33,35,61,129,1149,-3.557781574,130.7463468
KILMURY,22,582,246,88,916,32,19,50,101,1017,,
WERINAMA,30,460,127,71,658,7,15,35,57,715,-3.388031194,130.1727441
SIWALALAT,31,568,146,60,774,42,25,68,135,909,,
BULA,40,1586,442,206,2234,81,84,161,326,2560,-3.224135619,130.4146205
PP. WETAR,10,1024,238,57,1319,45,138,239,422,1741,-7.781422006,126.2973002
PP. TERSELATAN,20,1619,673,374,2666,29,97,285,411,3077,-7.670509018,127.3734275
LETI MOA LAKOR,30,898,289,146,1333,31,39,97,167,1500,-8.198253955,127.6745743
MOA LAKOR,40,1241,283,91,1615,23,65,113,201,1816,-8.194690723,127.9876413
DAMER,50,832,268,179,1279,21,20,73,114,1393,-7.14613501,128.6095616
MDONA HIERA,60,694,272,91,1057,26,31,99,156,1213,-8.203655661,128.9153206
PP. BABAR,70,855,225,87,1167,28,38,66,132,1299,-7.871147768,129.6426678
BABAR TIMUR,80,837,274,86,1197,24,37,100,161,1358,-7.932679651,129.7965408
KEPALA MADAN,10,1026,389,164,1579,94,81,154,329,1908,-3.363195373,126.1277541
LEKSULA,20,1399,361,131,1891,104,131,238,473,2364,-3.573416396,126.4377529
NAMROLE,30,743,265,135,1143,94,47,123,264,1407,-3.664415459,126.733808
WAISAMA,40,756,275,161,1192,145,65,104,314,1506,-3.638430335,126.9863834
AMBALAU,50,901,415,267,1583,27,17,74,118,1701,-3.948499969,127.2746353
NUSANIWE,10,3430,1372,820,5622,44,98,459,601,6223,-3.741911128,128.1572563
SIRIMAU,20,3524,1430,860,5814,156,154,487,797,6611,-3.6948101,128.2153297
TELUK AMBON,30,2000,747,474,3221,79,85,283,447,3668,-3.657977346,128.1186721
BAGUALA,40,1682,707,439,2828,35,45,224,304,3132,-3.623850029,128.2369046
LEITIMUR SELATAN,50,633,262,146,1041,11,7,73,91,1132,-3.698899132,128.2582887
PP. KUR,10,782,329,172,1283,18,17,103,138,1421,-5.385604241,131.9898865
TAYANDO TAM,20,853,298,167,1318,28,35,104,167,1485,-5.621587213,132.2882612
PULAU DULLAH UTARA,30,1459,590,428,2477,56,65,192,313,2790,-5.587349564,132.7722836
PULAU DULLAH SELATAN,40,1407,588,379,2374,82,65,235,382,2756,-5.627636146,132.7540164
JAILOLO,90,1569,617,351,2537,89,94,239,422,2959,1.061375996,127.5245846
JAILOLO SELATAN,91,610,260,147,1017,30,36,97,163,1180,0.872411083,127.5999023
JAILOLO TIMUR,92,105,34,24,163,5,8,14,27,190,,
SAHU,100,594,162,124,880,19,26,64,109,989,1.209670168,127.4517421
SAHU TIMUR,101,482,149,110,741,9,11,61,81,822,1.203609853,127.5653702
IBU,130,608,262,163,1033,17,26,94,137,1170,1.48624275,127.5916894
IBU SELATAN,131,1229,523,291,2043,121,132,312,565,2608,1.357863978,127.5635859
IBU UTARA,132,818,302,236,1356,26,42,116,184,1540,1.550832287,127.6577224
LOLODA,140,1230,447,221,1898,55,60,215,330,2228,1.744198134,127.6557855
WEDA,30,293,85,62,440,59,38,58,155,595,0.34182254,127.8458424
WEDA SELATAN,31,407,179,98,684,42,32,67,141,825,0.203574962,127.8589399
WEDA UTARA,32,752,252,131,1135,57,33,73,163,1298,0.505425944,128.218138
WEDA TENGAH,33,402,133,81,616,14,25,68,107,723,0.523601715,127.8926006
PULAU GEBE,41,361,183,116,660,17,12,34,63,723,-0.088821138,129.4935924
PATANI,42,418,153,96,667,57,19,74,150,817,0.276908502,128.7879747
PATANI UTARA,43,768,358,189,1315,45,19,96,160,1475,0.409909743,128.6828302
PATANI BARAT,44,387,166,96,649,11,6,27,44,693,0.385540251,128.5450775
SULA BESI BARAT,10,214,63,24,301,11,8,22,41,342,-2.161510073,125.9042379
SULABESI SELATAN,11,319,108,57,484,27,7,18,52,536,-2.344948552,125.9782457
SANANA,20,402,188,123,713,24,12,54,90,803,-2.091953415,125.9441926
SULA BESI TENGAH,21,232,102,74,408,8,5,18,31,439,-2.244638092,125.9754051
SULABESI TIMUR,22,342,105,49,496,19,8,25,52,548,-2.412820904,126.0344673
SANANA UTARA,23,216,93,51,360,16,12,29,57,417,-2.018210491,125.9251356
MANGOLI TIMUR,30,148,39,26,213,17,16,13,46,259,-1.862375527,126.0583043
MANGOLI TENGAH,31,334,130,62,526,17,16,27,60,586,-1.856376486,125.9011929
MANGOLI UTARA TIMUR,32,160,67,28,255,30,8,18,56,311,-1.839396318,126.2655168
MANGOLI BARAT,40,181,47,20,248,14,8,18,40,288,-1.847712833,125.4066396
MANGOLI UTARA,41,404,140,52,596,11,12,64,87,683,-1.834309065,125.6305234
MANGOLI SELATAN,42,277,108,53,438,19,6,25,50,488,-1.897936056,125.5905094
TALIABU TIMUR,50,181,72,38,291,42,38,56,136,427,-1.77003015,125.1344443
TALIABU TIMUR SELATAN,51,255,78,43,376,29,28,46,103,479,-1.860882016,125.0713372
TALIABU BARAT,60,388,123,73,584,40,54,80,174,758,-1.932079848,124.4848991
TALIABU UTARA,61,457,135,46,638,80,46,90,216,854,-1.733682165,124.7016357
TALIABU BARAT LAUT,62,68,27,18,113,4,3,9,16,129,-1.805828503,124.3866789
LEDE,63,119,39,21,179,18,18,24,60,239,-1.73328629,124.4512983
TALIABU SELATAN,64,371,131,70,572,88,52,52,192,764,-1.869515143,124.739408
OBI SELATAN,10,610,214,77,901,22,37,54,113,1014,-1.63392117,127.7028611
OBI,20,377,128,56,561,16,18,43,77,638,-1.463715429,127.6174403
OBI BARAT,21,116,34,11,161,4,7,13,24,185,-1.363495775,127.362255
OBI TIMUR,22,161,53,23,237,9,10,25,44,281,-1.588879773,128.0325366
OBI UTARA,23,217,70,21,308,10,14,30,54,362,-1.22323442,127.5671637
BACAN,30,445,125,56,626,12,36,63,111,737,-0.557069252,127.4439053
MANDIOLI SELATAN,31,426,114,35,575,24,33,46,103,678,-0.741341371,127.2365586
MANDIOLI UTARA,32,268,75,36,379,7,18,25,50,429,-0.666938582,127.2506911
BACAN SELATAN,33,206,69,36,311,9,14,23,46,357,-0.725639793,127.4911167
BATANG LOMANG,34,407,95,43,545,15,63,91,169,714,-0.636965203,127.3597669
BACAN TIMUR,40,183,38,22,243,9,7,13,29,272,-0.509733389,127.5877127
BACAN TIMUR SELATAN,41,434,87,12,533,16,47,62,125,658,-0.783767884,127.7005405
BACAN TIMUR TENGAH,42,221,51,23,295,4,17,25,46,341,-0.724058151,127.7505721
BACAN BARAT,50,134,17,7,158,4,31,30,65,223,-0.435507506,127.3454034
KASIRUTA BARAT,51,215,56,4,275,6,27,51,84,359,-0.386739745,127.1554169
KASIRUTA TIMUR,52,231,47,16,294,29,30,48,107,401,-0.369549629,127.2329495
BACAN BARAT UTARA,53,274,51,7,332,11,18,54,83,415,-0.410269233,127.4764666
KAYOA,60,567,168,71,806,23,30,81,134,940,-0.017988906,127.3121208
KAYOA BARAT,61,158,50,19,227,34,24,60,118,345,-0.216820534,127.1171016
KAYOA SELATAN,62,348,145,65,558,7,11,49,67,625,-0.05295296,127.4293324
KAYOA UTARA,63,175,65,41,281,2,2,18,22,303,0.070997428,127.443088
PULAU MAKIAN,70,315,160,91,566,2,2,20,24,590,0.327026083,127.4115109
MAKIAN BARAT,71,136,80,28,244,0,0,7,7,251,0.322019848,127.3725588
GANE BARAT,80,444,130,61,635,9,19,50,78,713,-0.449791356,127.9338905
GANE BARAT SELATAN,81,280,85,47,412,23,17,38,78,490,-0.763351262,128.1883461
GANE BARAT UTARA,82,381,131,57,569,11,7,39,57,626,-0.154066752,127.7495017
KEPULAUAN JORONGA,83,363,103,32,498,17,41,97,155,653,-1.01427879,128.3654778
GANE TIMUR,90,289,112,35,436,1,9,51,61,497,-0.066476434,127.8705817
GANE TIMUR TENGAH,91,197,29,15,241,11,16,21,48,289,-0.396001058,128.0022717
GANE TIMUR SELATAN,92,118,40,20,178,29,5,14,48,226,-0.667145497,128.2199751
MALIFUT,10,525,243,147,915,103,50,85,238,1153,1.154212679,127.7395907
KAO TELUK,11,300,102,45,447,6,18,45,69,516,1.012594798,127.6544566
KAO,20,462,181,84,727,22,41,120,183,910,1.229567656,127.8861478
KAO BARAT,21,578,231,116,925,30,43,102,175,1100,1.333748187,127.7939706
KAO UTARA,22,748,256,148,1152,88,100,153,341,1493,1.381053529,127.9737909
TOBELO SELATAN,30,815,342,174,1331,49,46,132,227,1558,1.617376473,127.9333361
TOBELO BARAT,31,393,102,59,554,95,49,77,221,775,,
TOBELO TIMUR,32,577,196,111,884,61,75,121,257,1141,1.548663423,128.0072101
TOBELO,40,879,367,194,1440,56,69,153,278,1718,1.71498739,127.9657063
TOBELO TENGAH,41,567,226,139,932,54,51,112,217,1149,1.676668327,127.9510839
TOBELO UTARA,42,589,283,177,1049,46,38,95,179,1228,1.73330782,127.8914304
GALELA,50,685,280,137,1102,34,21,79,134,1236,1.798787869,127.8555356
GALELA SELATAN,51,378,115,81,574,19,7,21,47,621,1.773306948,127.8085692
GALELA BARAT,52,897,356,259,1512,42,56,99,197,1709,1.83703483,127.7803502
GALELA UTARA,53,821,322,216,1359,66,65,111,242,1601,2.032463105,127.9260444
LOLODA UTARA,60,832,348,242,1422,106,48,105,259,1681,2.054733578,127.8668937
LOLODA KEPULAUAN,61,605,257,135,997,20,14,51,85,1082,2.224724309,127.781168
MABA SELATAN,10,262,151,86,499,179,33,57,269,768,0.533807744,128.5010016
KOTA MABA,11,198,91,62,351,15,5,24,44,395,0.700623808,128.1712371
WASILE SELATAN,20,739,342,204,1285,43,43,110,196,1481,0.859993237,127.9750001
WASILE,30,158,62,34,254,12,7,33,52,306,1.113618849,128.2724899
WASILE TIMUR,31,447,184,107,738,58,20,69,147,885,1.236435217,128.2825062
WASILE TENGAH,32,479,189,92,760,50,26,55,131,891,1.324514743,128.3250843
WASILE UTARA,33,295,112,54,461,43,20,68,131,592,1.460674414,128.4883569
MABA,40,238,89,57,384,18,20,57,95,479,0.940077596,128.2945528
MABA TENGAH,41,319,80,68,467,84,68,95,247,714,1.066318793,128.471868
MABA UTARA,42,730,238,121,1089,77,83,123,283,1372,1.272657448,128.6197869
MOROTAI SELATAN,10,942,352,214,1508,45,29,84,158,1666,2.11340408,128.3887137
MOROTAI TIMUR,20,401,124,65,590,35,35,46,116,706,2.200650784,128.5354929
MOROTAI SELATAN BARAT,30,625,179,91,895,70,62,98,230,1125,2.287890548,128.3252707
MOROTAI JAYA,40,606,235,94,935,39,40,93,172,1107,2.509217581,128.4814603
MOROTAI UTARA,50,683,239,84,1006,31,31,81,143,1149,2.389914656,128.5722956
PULAU TERNATE,10,527,220,159,906,28,12,87,127,1033,,
MOTI,11,346,123,74,543,29,20,51,100,643,0.455658874,127.4090784
PULAU BATANG DUA,12,268,90,42,400,13,12,36,61,461,1.266318638,126.3466886
PULAU HIRI,13,287,103,67,457,12,20,39,71,528,0.896044031,127.3179849
TERNATE SELATAN,20,877,344,252,1473,80,52,176,308,1781,0.769949204,127.3500872
TERNATE TENGAH,21,838,333,180,1351,41,66,173,280,1631,0.794008767,127.3680655
TERNATE UTARA,30,766,309,208,1283,27,32,153,212,1495,0.82114402,127.3732704
TIDORE SELATAN,10,822,385,293,1500,13,28,104,145,1645,0.629864963,127.3948296
TIDORE UTARA,20,719,307,190,1216,21,23,114,158,1374,0.704212079,127.3929032
TIDORE,30,693,290,185,1168,17,17,88,122,1290,0.665373889,127.4317989
TIDORE TIMUR,31,370,143,80,593,4,7,45,56,649,0.719986072,127.432941
OBA,40,434,187,110,731,30,18,80,128,859,0.329200858,127.7316554
OBA SELATAN,41,385,131,47,563,27,28,49,104,667,0.086285063,127.7501262
OBA UTARA,50,703,298,218,1219,30,28,96,154,1373,0.700546893,127.6649517
OBA TENGAH,51,370,132,87,589,32,17,46,95,684,0.549299046,127.6705935
FAKFAK TIMUR,50,335,139,103,577,66,20,35,121,698,-3.030697591,132.6014713
KARAS,51,393,146,77,616,41,14,33,88,704,-3.416174034,132.9744635
FAKFAK,60,2086,878,589,3553,175,85,309,569,4122,-2.892182761,132.2724345
FAKFAK TENGAH,61,927,309,240,1476,49,48,130,227,1703,-2.879299364,132.3507443
FAKFAK BARAT,70,547,205,123,875,16,8,49,73,948,-2.87957175,132.126943
KOKAS,80,480,146,63,689,46,42,69,157,846,-2.851108821,132.7114102
TELUK PATIPI,81,409,137,59,605,116,55,93,264,869,-2.750137303,132.1610365
KRAMONGMONGGA,82,412,148,82,642,33,42,60,135,777,-2.752794201,132.347434
BOMBERAY,83,254,133,76,463,11,20,93,124,587,-2.937555043,133.2221061
BURUWAY,10,482,138,63,683,46,27,80,153,836,-3.769311821,133.2105515
TELUK ARGUNI,20,479,126,63,668,75,53,74,202,870,-3.147982492,133.9805662
TELUK ARGUNI BAWAH,21,346,91,46,483,24,10,39,73,556,-3.249942794,133.5450441
KAIMANA,30,1373,531,320,2224,137,83,259,479,2703,-3.581065528,134.0737923
KAMBRAU,31,290,89,30,409,21,14,31,66,475,-3.409179857,133.5255914
TELUK ETNA,40,261,82,38,381,27,27,42,96,477,-3.996420253,134.6526591
YAMOR,41,273,41,6,320,32,45,76,153,473,-3.78717116,134.760421
NAIKERE,10,25,4,4,33,83,30,26,139,172,-3.218124319,134.4804642
WONDIBOY,20,155,77,42,274,20,13,21,54,328,-2.795495615,134.5782269
RASIEY,21,274,129,101,504,34,31,51,116,620,-2.878773022,134.5662436
KURI WAMESA,22,142,66,25,233,28,13,36,77,310,-2.785710171,134.2910794
WASIOR,30,558,209,163,930,50,32,90,172,1102,-2.690252999,134.5556788
DUAIRI,40,187,55,30,272,11,11,29,51,323,-2.54402596,134.5400178
ROON,41,171,59,15,245,30,19,39,88,333,-2.331841001,134.5587932
WINDESI,50,162,72,41,275,15,4,24,43,318,-2.547545336,134.2169824
NIKIWAR,51,98,29,22,149,6,4,11,21,170,-2.422292045,134.1260844
WAMESA,60,74,28,11,113,5,3,7,15,128,-2.14360655,134.0883871
ROSWAR,61,86,44,24,154,2,5,7,14,168,-2.069838817,134.3640282
RUMBERPON,70,209,81,38,328,26,20,32,78,406,-1.837986386,134.1841618
SOUG JAYA,71,73,35,10,118,19,7,19,45,163,-1.890915783,134.0634147
IRORUTU / FAFURWAR,10,139,47,28,214,23,6,26,55,269,-2.900031986,133.709851
BABO,20,308,137,86,531,19,14,40,73,604,-2.509501656,133.4526174
SUMURI,21,667,248,96,1011,50,58,142,250,1261,-2.540655398,133.210516
AROBA,22,222,69,15,306,17,21,71,109,415,-2.720443176,133.4752841
KAITARO,23,74,31,6,111,11,5,13,29,140,-2.712547254,133.7478139
KURI,30,110,52,25,187,23,7,27,57,244,-2.579812696,133.957727
WAMESA,40,169,58,30,257,15,8,25,48,305,-2.141897709,133.9389635
BINTUNI,50,715,299,218,1232,93,55,156,304,1536,-2.129267619,133.5829409
MANIMERI,51,371,148,80,599,33,22,74,129,728,-1.986077289,133.7656467
TUHIBA,52,72,30,11,113,8,3,18,29,142,-1.941642967,133.6057171
DATARAN BEIMES,53,39,6,1,46,11,8,7,26,72,-1.702775178,133.720827
TEMBUNI,60,114,31,7,152,4,7,38,49,201,-1.874699763,133.4598247
ARANDAY,70,162,40,8,210,33,19,35,87,297,-2.026247696,133.2624788
KAMUNDAN,71,109,26,16,151,8,4,19,31,182,-2.026987647,132.6538039
TOMU,72,344,132,75,551,38,23,60,121,672,-2.076097209,133.1449747
WERIAGAR,73,194,66,28,288,32,9,32,73,361,-2.06068794,132.8926455
MOSKONA SELATAN,80,55,23,2,80,7,1,15,23,103,-1.71293033,132.9026656
MEYADO,81,143,45,17,205,6,11,26,43,248,-1.719067284,133.1801729
MOSKONA BARAT,82,26,15,4,45,14,11,7,32,77,-1.724646119,132.6453287
MERDEY,90,20,10,3,33,32,13,11,56,89,-1.425913502,133.2831197
BISCOOP,91,30,16,7,53,21,8,16,45,98,-1.548258792,133.5111405
MASYETA,92,24,5,0,29,25,12,23,60,89,-1.487823442,132.9088869
MOSKONA UTARA,100,103,23,1,127,17,15,40,72,199,-1.293744913,132.7791089
MOSKONA TIMUR,101,87,18,3,108,51,20,52,123,231,-1.30523309,132.976996
RANSIKI,40,737,309,179,1225,167,77,125,369,1594,-1.455927432,134.12167
MOMI WAREN,41,184,89,52,325,141,45,64,250,575,-1.585404598,134.060118
NENEI,42,65,34,28,127,86,29,26,141,268,-1.507333206,133.9674673
SURUREY,80,95,56,32,183,116,52,84,252,435,-1.417991095,133.8635899
ANGGI,90,153,39,34,226,129,33,41,203,429,-1.292254485,133.912679
TAIGE,91,116,26,15,157,38,7,10,55,212,-1.299521,133.8453638
MEMBEY,92,53,18,8,79,94,30,38,162,241,-1.309675172,134.0316281
ORANSBARI,100,451,193,125,769,120,40,90,250,1019,-1.32182361,134.1776252
WARMARE,110,483,211,85,779,127,60,141,328,1107,-0.971276908,133.9203249
PRAFI,120,374,181,112,667,98,54,83,235,902,-0.881596752,133.8477334
MENYAMBOUW,130,591,203,120,914,247,69,128,444,1358,-1.094052009,133.9063717
CATUBOUW,131,119,57,36,212,137,38,60,235,447,-1.066362742,133.721867
MANOKWARI BARAT,141,2285,929,795,4009,265,130,340,735,4744,-0.846255638,134.0429093
MANOKWARI TIMUR,142,707,339,209,1255,98,55,148,301,1556,-0.870548432,134.1055249
MANOKWARI UTARA,143,226,98,46,370,52,12,45,109,479,-0.785091336,133.9203393
MANOKWARI SELATAN,144,788,298,227,1313,101,40,141,282,1595,-0.976739506,134.0094311
TESTEGA,145,53,24,7,84,62,25,36,123,207,-1.137299065,133.5092
TANAH RUBU,146,222,90,47,359,93,41,93,227,586,-1.186524699,134.0998984
KEBAR,150,233,96,51,380,62,8,29,99,479,-1.025699261,133.2304168
SENOPI,151,106,39,19,164,17,3,16,36,200,-1.008792916,132.8460964
AMBERBAKEN,160,299,113,91,503,26,12,30,68,571,-0.662016926,133.0469316
MUBARNI / ARFU,161,97,44,22,163,3,5,12,20,183,-0.774678828,133.3194287
MASNI,170,918,362,251,1531,100,63,184,347,1878,-0.821205915,133.7126641
SIDEY,171,424,181,97,702,66,23,154,243,945,-0.818933021,133.5531977
TAHOSTA,180,52,16,2,70,42,16,23,81,151,-1.835590872,133.9555254
DIDOHU,190,137,28,12,177,99,35,22,156,333,-1.287314078,133.6925815
DATARAN ISIM,200,208,62,39,309,123,45,61,229,538,-1.558295139,133.8013014
ANGGI GIDA,210,119,39,18,176,57,24,33,114,290,-1.389337561,133.9813828
HINGK,220,44,10,4,58,695,358,296,1349,1407,-1.208230875,133.9519705
INANWATAN,10,325,161,127,613,48,16,20,84,697,-2.093697974,132.2260734
METEMANI,11,281,112,87,480,48,15,24,87,567,-1.98138039,132.1652333
KOKODA,20,787,331,163,1281,231,87,111,429,1710,-2.159079397,132.3745135
KAIS,21,412,150,116,678,48,35,60,143,821,-1.761726156,132.2144261
KOKODA UTARA,22,203,69,33,305,82,26,37,145,450,-1.987191221,132.4068024
MOSWAREN,60,187,76,55,318,8,8,36,52,370,-1.521189861,132.2472923
TEMINABUAN,70,496,209,212,917,137,35,70,242,1159,-1.422520318,132.0410496
SEREMUK,71,152,68,40,260,16,8,25,49,309,-1.423406058,131.9493996
WAYER,72,170,80,60,310,18,4,23,45,355,-1.530289663,132.1406432
KONDA,73,160,55,26,241,49,20,25,94,335,-1.602121082,131.9893291
SAIFI,74,262,100,92,454,16,9,13,38,492,-1.490140156,131.8395147
SAWIAT,80,245,86,43,374,49,16,23,88,462,-1.196319337,131.9362697
FOKOUR,81,80,30,12,122,15,8,7,30,152,-1.139630453,132.0109458
MORAID,60,149,70,35,254,30,11,25,66,320,-0.658740957,131.982197
KLASO,61,13,14,4,31,24,10,8,42,73,-0.773270485,131.8827491
MAKBON,100,268,77,77,422,60,11,21,92,514,-0.810632364,131.5675583
KLAYILI,101,48,24,4,76,18,4,10,32,108,-0.912273283,131.56922
BERAUR,110,137,27,10,174,15,12,19,46,220,,
KLAMONO,111,416,163,87,666,70,29,69,168,834,-1.144559427,131.4735303
KLABOT,112,89,19,5,113,20,3,7,30,143,-1.409418291,131.7953656
KLAWAK,113,75,15,10,100,5,13,15,33,133,-1.206681349,131.7787739
SALAWATI,120,1007,409,207,1623,46,42,162,250,1873,-1.161128019,131.2962437
MAYAMUK,121,914,364,272,1550,72,42,128,242,1792,-1.070291768,131.3071627
SALAWATI TIMUR,122,274,108,50,432,12,6,68,86,518,-1.287996563,131.2651335
SEGET,130,352,133,73,558,70,29,55,154,712,-1.370463915,131.0813681
SEGUN,131,141,55,22,218,56,26,26,108,326,-1.407725761,131.3499836
SALAWATI SELATAN,132,266,96,61,423,53,25,60,138,561,-1.248341197,130.9030372
AIMAS,170,1235,507,352,2094,87,52,200,339,2433,-0.987724907,131.386753
MARIAT,171,746,325,203,1274,46,27,108,181,1455,-1.024041235,131.3609689
SAYOSA,180,120,32,13,165,18,8,25,51,216,-1.019009337,131.7283589
MAUDUS,181,36,9,4,49,26,11,15,52,101,-0.912689124,132.0263515
MISOOL SELATAN,11,267,87,67,421,37,12,58,107,528,-2.001021824,130.3171937
MISOOL BARAT,12,139,76,30,245,22,7,23,52,297,-1.955296828,130.141143
MISOOL,20,222,100,59,381,13,10,31,54,435,-1.851334075,129.9310802
KOFIAU,21,297,150,129,576,92,18,41,151,727,-1.176785467,129.7716938
MISOOL TIMUR,22,250,70,18,338,30,32,48,110,448,-1.807212041,130.294466
KEPULAUAN SEMBILAN,23,192,86,49,327,27,11,42,80,407,-1.451676476,130.2391066
SALAWATI UTARA,31,511,238,158,907,70,59,111,240,1147,-1.046978261,130.8883545
SELAT SAGAWIN,32,282,98,78,458,38,29,49,116,574,-0.846299906,130.654824
WAIGEO SELATAN,40,478,174,155,807,58,24,60,142,949,-0.37456833,130.7498179
TELUK MAYALIBIT,41,228,82,55,365,16,21,33,70,435,-0.221453636,130.7530493
MEOS MANSAR,42,254,60,33,347,16,21,20,57,404,-0.471478365,130.5750836
WAIGEO BARAT,50,179,55,27,261,17,11,42,70,331,-0.18045716,130.3780199
WAIGEO BARAT KEPULAUAN,51,337,102,48,487,21,22,51,94,581,-0.475009993,130.0460145
WAIGEO UTARA,60,321,97,72,490,22,8,30,60,550,-0.093047439,130.8733661
WARWARBOMI,61,144,69,12,225,25,32,34,91,316,-0.170866454,131.1154532
KEPULAUAN AYAU,70,321,103,65,489,16,12,36,64,553,0.450289023,131.122436
WAIGEO TIMUR,80,196,80,48,324,8,8,25,41,365,-0.273017591,131.2044869
FEF,10,53,16,10,79,10,3,3,16,95,,
SYUJAK,11,32,12,5,49,13,2,2,17,66,-0.682422075,132.4419219
MIYAH,20,44,11,3,58,19,10,15,44,102,-0.774916908,132.706487
ABUN,30,87,24,6,117,9,5,10,24,141,-0.486647548,132.7127813
KWOOR,40,61,23,4,88,87,30,69,186,274,-0.49631564,132.3890531
SAUSAPOR,50,396,119,71,586,53,20,42,115,701,-0.537128387,132.1875693
YEMBUN,60,58,20,12,90,100,16,12,128,218,-0.740928819,132.2070762
AITINYO BARAT/ATHABU,10,234,103,75,412,22,37,47,106,518,-1.393719228,132.2170623
AITINYO,20,522,338,293,1153,67,30,116,213,1366,-1.446705751,132.3534811
AIFAT SELATAN,30,118,57,55,230,57,28,49,134,364,-1.534408031,132.4853914
AIFAT,40,272,78,210,560,39,7,34,80,640,-1.276793311,132.4716311
AITINYO UTARA,50,255,146,89,490,12,15,34,61,551,-1.325034372,132.3442198
AYAMARU TIMUR,60,134,51,47,232,4,3,12,19,251,-1.288600313,132.270835
AYAMARU,70,641,328,355,1324,42,16,40,98,1422,-1.287098938,132.137021
AYAMARU UTARA,80,376,207,186,769,32,10,31,73,842,-1.179170867,132.1849747
MARE,90,122,46,33,201,21,3,12,36,237,-1.121950114,132.2445436
AIFAT UTARA,100,224,137,154,515,26,15,35,76,591,-1.158248294,132.461659
AIFAT TIMUR,110,230,99,147,476,68,15,61,144,620,-1.263033378,132.63218
SORONG BARAT,10,2181,923,545,3649,163,100,344,607,4256,-0.819628879,131.3055036
SORONG KEPULAUAN,11,946,405,235,1586,50,40,135,225,1811,-0.89553015,131.2211396
SORONG TIMUR,20,909,343,233,1485,86,27,121,234,1719,-0.909526026,131.3675584
SORONG UTARA,21,1778,746,455,2979,56,78,311,445,3424,-0.848465867,131.336932
SORONG,22,1457,651,450,2558,49,54,210,313,2871,-0.87444656,131.2682884
SORONG MANOI,23,2173,883,544,3600,165,134,363,662,4262,-0.89307347,131.2879916
KIMAAM,10,716,239,117,1072,151,106,184,441,1513,-8.005817838,138.7735921
WAAN,11,616,158,27,801,59,66,203,328,1129,-8.175284626,138.0782211
TABONJI,12,817,229,44,1090,25,93,220,338,1428,-7.668196744,138.3698597
ILYAWAB,13,521,131,37,689,29,33,97,159,848,-7.503360996,139.0650534
OKABA,20,587,211,158,956,73,44,110,227,1183,-8.047266293,139.5587333
TUBANG,21,232,75,34,341,50,47,105,202,543,-7.80794027,139.3248132
NGGUTI,22,306,106,36,448,17,22,69,108,556,-7.616176003,139.6085398
KAPTEL,23,226,57,7,290,13,32,75,120,410,-7.676298377,139.9949558
KURIK,30,645,257,178,1080,123,70,141,334,1414,-8.166431243,140.2961171
MALIND,31,484,212,131,827,82,36,75,193,1020,-8.211114916,140.1124365
ANIMHA,32,200,57,19,276,138,90,80,308,584,-7.933646363,140.3494294
MERAUKE,40,2266,827,665,3758,358,257,439,1054,4812,-8.517817984,140.5575492
SEMANGGA,41,434,192,109,735,238,91,181,510,1245,-8.395452339,140.3771591
TANAH MIRING,42,1269,428,177,1874,69,107,270,446,2320,-8.308808984,140.5814709
JAGEBOB,43,682,248,157,1087,69,57,172,298,1385,-7.986495247,140.698678
SOTA,44,292,154,129,575,96,14,37,147,722,-8.308584837,140.9053559
NAUKENJERAI,45,236,79,39,354,15,30,66,111,465,-8.827594894,140.8062912
MUTING,50,501,205,156,862,49,35,118,202,1064,-7.317265631,140.4131074
ELIGOBEL,51,526,198,180,904,29,23,72,124,1028,-7.563642276,140.7854541
ULILIN,52,310,99,75,484,68,42,88,198,682,-7.042627084,140.8212229
WAMENA,110,989,446,415,1850,1540,656,643,2839,4689,-4.270286094,138.7461469
ASOLOKOBAL,111,1597,848,633,3078,869,324,374,1567,4645,-4.179042438,138.9612113
WALELAGAMA,112,1114,487,213,1814,816,403,539,1758,3572,-4.088151334,139.1614372
HUBIKOSI,120,1683,725,553,2961,972,452,572,1996,4957,-4.064029589,138.8663251
PELEBAGA,121,719,317,430,1466,739,297,557,1593,3059,-4.097676939,138.724145
ASOLOGAIMA,180,2192,1498,1047,4737,1964,1113,1395,4472,9209,-3.969371542,138.7630215
MUSATFAK,181,356,242,154,752,225,183,270,678,1430,-3.983966277,138.8639932
KURULU,190,2256,1120,637,4013,1121,500,618,2239,6252,-3.969236374,138.9329799
BOLAKME,220,602,240,167,1009,553,208,272,1033,2042,-3.826868542,138.7046634
WOLLO,221,308,186,86,580,238,112,91,441,1021,-3.827521121,138.8439889
YALENGGA,222,358,134,66,558,136,41,33,210,768,-3.885100849,138.8021696
KAUREH,80,433,116,47,596,39,37,103,179,775,-3.183480522,139.857781
AIRU,81,69,21,13,103,74,51,27,152,255,-3.555404536,140.1413124
YAPSI,82,498,260,136,894,56,26,98,180,1074,-2.866421311,140.1404791
KEMTUK,140,434,165,125,724,51,28,69,148,872,-2.682093746,140.4304223
KEMTUK GRESI,150,481,237,139,857,35,17,55,107,964,-2.721123281,140.3029341
GRESI SELATAN,151,131,53,30,214,3,0,12,15,229,-2.703683902,140.1963653
NIMBORAN,160,425,180,152,757,20,13,28,61,818,-2.627311569,140.1320749
NIMBORAN TIMUR / NAMBLONG,161,185,79,53,317,11,5,28,44,361,-2.60289516,140.2112379
NIMBOKRANG,170,211,108,70,389,10,4,21,35,424,-2.525733125,140.1605504
UNURUM GUAY,180,186,66,30,282,65,28,40,133,415,-2.614682727,139.7556016
DEMTA,200,361,185,93,639,13,9,37,59,698,-2.397672344,140.0899322
YOKARI,201,294,84,28,406,31,12,37,80,486,-2.466754278,140.2424219
DEPAPRE,210,478,219,139,836,45,12,44,101,937,-2.452963132,140.3856583
RAVENIRARA,211,170,23,5,198,15,18,28,61,259,-2.473745815,140.5392964
SENTANI BARAT,220,190,105,63,358,4,3,33,40,398,-2.52591883,140.36278
WAIBU,221,455,187,107,749,35,21,80,136,885,-2.563487723,140.436549
SENTANI,230,1160,556,347,2063,56,23,144,223,2286,-2.568032108,140.5135289
EBUNGFAU,231,304,130,92,526,27,11,48,86,612,-2.657106348,140.5168249
SENTANI TIMUR,240,776,402,251,1429,61,24,126,211,1640,-2.611810288,140.589746
UWAPA,50,352,135,88,575,53,33,65,151,726,-3.428235088,135.6442305
MENOU,51,173,15,1,189,190,55,37,282,471,-3.54828572,135.6403821
DIPA,52,62,7,4,73,502,160,121,783,856,-3.726749812,135.7110134
YAUR,60,221,41,5,267,10,33,55,98,365,-3.395424632,134.8572079
TELUK UMAR,61,135,69,26,230,13,9,26,48,278,-2.937955272,134.7056366
WANGGAR,70,534,174,98,806,66,30,112,208,1014,-3.429116882,135.3767858
NABIRE BARAT,71,475,179,86,740,97,45,155,297,1037,-3.421384902,135.4635165
NABIRE,80,1463,640,403,2506,675,348,488,1511,4017,-3.373861598,135.541684
TELUK KIMI,81,832,314,187,1333,104,92,201,397,1730,-3.273763527,135.622704
NAPAN,90,328,119,76,523,26,20,35,81,604,-3.035839998,135.9820575
MAKIMI,91,459,208,111,778,73,46,146,265,1043,-3.221166253,135.9177292
WAPOGA,92,45,14,7,66,19,12,17,48,114,-2.879494084,136.1363164
SIRIWO,100,152,43,18,213,699,306,199,1204,1417,-3.384171743,136.1040503
YARO,110,302,105,63,470,173,51,88,312,782,-3.64293999,135.2794841
YAPEN TIMUR,40,359,145,65,569,8,14,47,69,638,-1.817215018,136.6897258
YAPEN UTARA,41,309,117,80,506,38,12,30,80,586,-1.744403758,136.3892358
TELUK AMPIMOI,42,529,180,107,816,53,37,56,146,962,-1.835656274,136.5249022
RAIMBAWI,43,133,52,23,208,54,18,35,107,315,-1.776468502,136.7572152
PULAU KURUDU,44,201,73,31,305,26,9,23,58,363,,
ANGKAISERA,50,911,372,222,1505,67,80,139,286,1791,-1.834916454,136.3691118
KEP. AMBAI,51,524,206,92,822,73,45,88,206,1028,-1.921939227,136.3414882
YAPEN SELATAN,60,1580,688,537,2805,91,60,229,380,3185,-1.832275089,136.2429404
KOSIWO,61,493,164,84,741,71,40,64,175,916,-1.795132607,136.0943363
YAPEN BARAT,70,944,352,225,1521,320,96,167,583,2104,-1.722362031,135.8355152
WONAWA,71,353,145,61,559,132,68,61,261,820,-1.581503275,135.3869542
PULAU YERUI,72,10,6,2,18,42,19,21,82,100,,
POOM,80,423,153,38,614,105,68,125,298,912,-1.644251614,135.6879402
WINDESI,81,365,95,36,496,61,56,87,204,700,-1.690804868,136.0436339
NUMFOR BARAT,10,238,127,105,470,86,12,42,140,610,-1.03255862,134.8465392
ORKERI,11,236,93,66,395,23,8,20,51,446,-1.113492336,134.8959532
NUMFOR TIMUR,20,66,33,30,129,23,5,18,46,175,-0.963878065,134.8617562
BRUYADORI,21,280,110,83,473,24,9,12,45,518,-1.057726904,134.9411138
POIRU,22,219,120,74,413,40,17,44,101,514,-0.985978953,134.9136945
PADAIDO,30,194,62,25,281,21,26,56,103,384,-1.231965549,136.3661908
AINANDO PADAIDO,31,312,96,61,469,13,10,25,48,517,-1.222781179,136.5987598
BIAK TIMUR,40,787,342,245,1374,19,25,75,119,1493,-1.126597055,136.1923607
ORIDEK,41,691,292,209,1192,38,25,64,127,1319,-1.085565455,136.2826399
BIAK KOTA,50,2926,1224,967,5117,167,141,391,699,5816,-1.176497796,136.095028
SAMOFA,60,1454,617,491,2562,63,60,197,320,2882,-1.142648301,136.0952593
YENDIDORI,70,927,391,257,1575,38,47,156,241,1816,-1.092817124,135.9574559
BIAK UTARA,80,819,334,336,1489,15,19,60,94,1583,-1.005501053,136.0669425
ANDEY,81,329,134,91,554,30,10,44,84,638,-0.919954945,135.9431021
WARSA,90,544,283,272,1099,58,34,64,156,1255,-0.80594231,135.8880042
YAWOSI,91,208,119,65,392,15,7,24,46,438,-0.834921686,135.9917839
BONDIFUAR,92,27,21,21,69,1,0,2,3,72,-0.732215184,135.8281239
BIAK BARAT,100,733,321,278,1332,28,19,65,112,1444,-1.055083062,135.8607384
SWANDIWE,101,524,226,195,945,66,27,41,134,1079,-0.868142759,135.8095193
PANIAI TIMUR,30,2244,817,362,3423,1695,851,1347,3893,7316,-3.947687091,136.5253028
YATAMO,31,436,133,116,685,2326,487,355,3168,3853,-3.966105826,136.3140134
KEBO,32,860,352,240,1452,2708,707,756,4171,5623,-3.816173652,136.3587497
BIBIDA,40,245,110,77,432,57,24,14,95,527,-3.977002753,136.7399315
DUMADAMA,41,0,0,0,0,938,322,301,1561,1561,-4.012918105,136.9426506
ARADIDE,70,646,416,451,1513,663,360,412,1435,2948,-3.770983777,136.5423707
EKADIDE,71,777,283,186,1246,3291,1577,1312,6180,7426,-3.847706081,136.5820434
PANIAI BARAT,80,2176,1302,971,4449,2719,1466,1063,5248,9697,-3.817284861,136.2337515
SIRIWO,81,0,0,0,0,834,171,218,1223,1223,-3.62322563,136.1257067
BOGOBAIDA,90,359,130,110,599,1237,337,249,1823,2422,-3.591119905,136.3650202
FAWI,40,209,78,47,334,346,141,214,701,1035,-3.333959897,137.7330018
MULIA,50,1410,558,498,2466,1020,369,590,1979,4445,-3.75523797,137.9555818
MEWOLUK,51,67,29,20,116,525,208,194,927,1043,-3.599882273,137.856586
YAMO,52,891,311,147,1349,846,354,460,1660,3009,-3.544995195,137.9924042
ILU,60,871,437,232,1540,1650,679,480,2809,4349,-3.744977031,138.1940741
TORERE,61,182,78,83,343,732,325,285,1342,1685,-3.605556892,138.1124498
JIGONIKME,62,229,128,217,574,815,227,459,1501,2075,-3.711610966,138.2511801
TINGGINAMBUT,70,478,379,282,1139,2334,1068,949,4351,5490,-3.727739807,138.0764685
MIMIKA BARAT,10,440,88,47,575,29,77,134,240,815,-4.498597371,136.3245511
MIMIKA BARAT JAUH,11,224,57,3,284,17,40,73,130,414,-4.28930677,135.2527651
MIMIKA BARAT TENGAH,12,221,119,26,366,35,9,98,142,508,-4.36793991,135.8797114
MIMIKA TIMUR,20,653,237,103,993,232,100,226,558,1551,-4.738456273,136.795223
MIMIKA TENGAH,21,354,102,46,502,124,75,120,319,821,-4.718941165,136.6258828
MIMIKA TIMUR JAUH,22,384,84,18,486,81,80,156,317,803,-4.736160327,137.1212299
MIMIKA BARU,30,4975,1667,852,7494,768,351,954,2073,9567,-4.561332763,136.844451
KUALA KENCANA,31,962,385,185,1532,152,141,239,532,2064,-4.371762267,136.7182141
TEMBAGAPURA,32,144,23,9,176,676,205,188,1069,1245,-4.264925196,137.1358313
AGIMUGA,40,105,46,14,165,7,9,26,42,207,-4.641605629,137.4683643
JILA,41,419,199,26,644,143,42,226,411,1055,-4.306201177,137.4995129
JITA,42,197,59,43,299,46,26,37,109,408,-4.968028761,137.5555574
JAIR,10,1635,457,271,2363,207,127,366,700,3063,-6.492851511,140.5308755
SUBUR,11,177,47,19,243,23,12,48,83,326,-6.914560059,140.3209123
KIA,13,221,75,23,319,42,19,61,122,441,-6.668540614,140.1469251
MINDIPTANA,20,344,158,163,665,52,24,45,121,786,-5.943676196,140.700616
INIYANDIT,21,94,38,13,145,8,14,25,47,192,-5.809625318,140.6240415
KOMBUT,22,112,30,10,152,7,12,24,43,195,-5.969001063,140.8960021
SESNUK,23,181,23,6,210,20,10,31,61,271,-6.183831042,140.790835
MANDOBO,30,546,231,175,952,82,52,88,222,1174,-6.109967654,140.2190492
FOFI,31,353,86,24,463,29,25,41,95,558,-6.300707076,139.945464
ARIMOP,32,151,69,42,262,27,10,16,53,315,-5.74159165,140.4894819
KOUH,40,154,47,47,248,17,8,11,36,284,-5.864100686,140.2482485
BOMAKIA,41,330,125,78,533,42,17,42,101,634,-5.773452145,139.8558457
FIRIWAGE,42,163,35,6,204,59,21,32,112,316,-5.362359682,140.1526853
MANGGELUM,43,200,34,9,243,66,20,32,118,361,-5.306731046,140.429033
YANIRUMA,44,72,17,8,97,18,9,21,48,145,-5.357011044,139.8141083
KAWAGIT,45,174,50,15,239,18,8,9,35,274,-5.6586319,140.2007404
KOMBAY,46,99,13,12,124,30,12,15,57,181,-5.362117209,139.9856889
WAROPKO,50,196,109,43,348,44,26,50,120,468,-5.520324303,140.8693715
AMBATKWI,51,106,24,23,153,22,7,16,45,198,-5.400702251,140.6560459
NINATI,52,73,32,11,116,14,6,12,32,148,-5.69549652,140.9303291
NAMBIOMAN BAPAI,10,969,233,78,1280,201,203,270,674,1954,-6.863121244,139.0132128
MINYAMUR,11,646,131,22,799,75,122,232,429,1228,-6.5866247,138.8732773
EDERA,20,1082,367,192,1641,517,255,429,1201,2842,-7.11411788,139.5013048
VENAHA,21,368,149,96,613,282,69,127,478,1091,-6.877822127,139.9231136
OBAA,30,1768,585,361,2714,496,234,392,1122,3836,-6.500628275,139.4210399
PASSUE,31,737,296,134,1167,230,72,147,449,1616,-6.415847753,139.6836408
HAJU,40,1028,408,260,1696,434,138,207,779,2475,-6.27044031,139.0958234
ASSUE,50,967,362,211,1540,202,78,165,445,1985,-5.947577622,139.1274166
CITAKMITAK,60,869,285,134,1288,329,170,286,785,2073,-5.843894579,139.4652589
KAIBAR,61,339,110,45,494,282,98,83,463,957,-5.578017655,139.5986349
PANTAI KASUARI,10,1731,467,157,2355,1171,429,626,2226,4581,-6.275037663,138.6934297
FAYIT,20,489,167,123,779,606,143,228,977,1756,-6.046834281,138.5327175
ATSY,30,1564,661,159,2384,726,352,712,1790,4174,-5.714333533,138.6528699
SUATOR,40,559,148,40,747,390,157,224,771,1518,-5.189645313,139.1642182
AKAT,50,601,130,52,783,307,220,297,824,1607,-5.258304033,138.6010422
AGATS,60,942,294,234,1470,267,131,222,620,2090,-5.526255055,138.1617556
SAWA ERMA,70,743,255,106,1104,1412,363,454,2229,3333,-4.988638256,138.0693853
SURU-SURU,71,50,26,6,82,113,32,36,181,263,-4.835726216,138.6962598
KURIMA,10,504,258,161,923,367,128,143,638,1561,-4.230462706,139.0350422
MUSAIK,11,10,16,6,32,764,221,214,1199,1231,-4.652359025,138.9493694
DEKAI,13,156,84,49,289,170,66,67,303,592,-4.889038463,139.5378874
OBIO,14,241,3,0,244,703,242,156,1101,1345,-4.649225922,139.1780872
PASEMA,15,86,36,5,127,264,106,73,443,570,-4.38325571,139.0962905
AMUMA,16,270,133,79,482,597,226,187,1010,1492,-4.561436165,138.9462466
SURU-SURU,17,396,92,27,515,245,100,91,436,951,-4.710182022,139.0504169
WUSAMA,18,162,105,64,331,667,318,222,1207,1538,-4.469574681,138.8812411
SILIMO,19,524,292,202,1018,512,202,173,887,1905,-4.485386395,138.9985733
NINIA,20,233,173,118,524,530,174,140,844,1368,-4.313736957,139.3401809
HOLUWON,21,529,202,130,861,294,75,108,477,1338,-4.427657556,139.2585586
LOLAT,22,68,49,17,134,710,320,238,1268,1402,-4.443176662,139.4864512
LANGDA,23,120,53,35,208,285,118,84,487,695,-4.445807621,139.3849987
BOMELA,24,163,36,7,206,120,53,46,219,425,-4.796916449,139.8626726
SUNTAMON,25,156,54,14,224,86,44,32,162,386,-4.817399758,140.1424483
SOBAHAM,26,104,71,48,223,519,148,102,769,992,-4.330148426,139.2454164
KORUPUN,27,451,175,56,682,489,270,239,998,1680,-4.582810578,139.6092315
SELA,28,212,115,60,387,566,322,313,1201,1588,-4.539260742,139.8169324
KWELAMDUA,29,221,93,51,365,258,149,145,552,917,-4.703377161,139.6693663
ANGGRUK,30,60,30,18,108,263,69,66,398,506,-4.198809462,139.4778748
PANGGEMA,31,231,104,15,350,354,166,118,638,988,-4.135241764,139.4041416
WALMA,32,156,84,49,289,223,49,51,323,612,-4.244699497,139.4010861
KOSAREK,33,50,43,8,101,733,306,196,1235,1336,-4.211417773,139.5772243
UBAHAK,34,347,155,80,582,1012,254,158,1424,2006,-4.282236914,139.5071172
NALCA,35,337,80,37,454,329,73,93,495,949,-4.378162901,139.7812972
PULDAMA,36,162,35,9,206,191,52,42,285,491,-4.340334072,139.8864601
NIPSAN,37,49,31,30,110,403,160,122,685,795,-4.136838632,139.6569432
SAMENAGE,41,200,78,4,282,70,72,104,246,528,-4.401391199,138.8864409
TANGMA,42,269,88,46,403,442,160,171,773,1176,-4.261878435,138.9930057
SOBA,43,46,21,9,76,127,29,18,174,250,-4.381669771,139.1588425
MUGI,44,293,82,39,414,400,86,69,555,969,-4.361569655,138.9983038
YOGOSEM,45,96,13,9,118,62,7,17,86,204,-4.230516972,139.1588687
KAYO,46,105,29,10,144,125,38,16,179,323,-4.48891651,139.244344
SUMO,47,121,37,3,161,261,292,374,927,1088,-4.76257418,139.3513922
HOGIO,48,232,110,55,397,411,140,95,646,1043,-4.414543175,139.0529118
UKHA,49,293,94,52,439,629,209,140,978,1417,-4.314060858,138.9060995
WERIMA,51,215,17,8,240,273,374,450,1097,1337,-4.254293728,139.0891052
SOLOIKMA,52,42,16,9,67,718,250,152,1120,1187,-4.3718901,139.4275854
SERADALA,53,146,106,44,296,618,266,282,1166,1462,-5.003229424,139.9910655
KABIANGGAMA,54,205,72,29,306,197,55,60,312,618,-4.398157332,139.3069099
KWIKMA,55,110,69,37,216,251,64,40,355,571,-4.511215454,139.3742156
HILIPUK,56,403,246,151,800,508,181,114,803,1603,-4.57796279,139.3750583
YAHULIAMBUT,57,35,10,6,51,152,51,29,232,283,-4.068337581,139.6179163
HEREAPINI,58,255,190,198,643,1189,678,661,2528,582,-3.94147988,139.7731666
UBALIHI,59,142,96,59,297,716,335,184,1235,293,-4.046141394,139.7817682
TALAMBO,61,157,191,259,607,812,709,648,2169,328,-3.791701596,139.9846611
PRONGGOLI,62,189,146,264,599,953,560,768,2281,118,-4.205919675,139.2704729
ENDOMEN,63,372,127,84,583,1771,404,205,2380,362,-4.211041234,139.9215902
KONA,65,276,137,123,536,1352,519,359,2230,240,-4.007089256,139.9360262
DURAM,66,460,88,13,561,2201,353,48,2602,481,-4.49963091,139.559582
DIRWEMNA,67,217,111,17,345,1113,449,61,1623,446,-4.20010497,139.7520994
IWUR,10,88,102,60,250,203,53,76,332,186,-5.044917122,140.8495186
KAWOR,11,34,8,8,50,180,19,44,243,523,-5.108392454,140.5462038
TARUP,12,44,45,22,111,150,34,33,217,154,-5.198296862,140.8743703
AWINBON,13,4,7,2,13,77,15,13,105,168,-5.054298916,140.2968947
OKSIBIL,20,83,80,60,223,93,17,29,139,228,-4.93492467,140.6553694
PEPERA,21,19,16,12,47,129,33,31,193,850,-4.913619565,140.753917
ALEMSOM,22,96,77,39,212,173,48,48,269,972,-4.734139019,140.2817298
SERAMBAKON,23,86,70,25,181,168,39,58,265,1038,-4.863518241,140.3810703
KOLOMDOL,24,17,26,9,52,87,25,22,134,629,-4.956122257,140.5807109
OKSOP,25,116,77,23,216,236,38,33,307,466,-4.739941599,140.437196
SEBANG,26,11,9,1,21,88,33,12,133,579,-4.753841486,140.7349328
OK BAPE,27,13,6,0,19,99,32,18,149,370,-4.722154844,140.5222611
OK AON,28,68,33,19,120,82,8,18,108,345,-4.809960892,140.6234172
BORME,30,24,85,30,139,366,167,178,711,238,-4.226522584,140.325701
BIME,31,37,23,17,77,571,179,145,895,723,-4.539049534,140.2122316
EPUMEK,32,166,106,81,353,446,105,134,685,409,-4.437246628,140.0795495
WEIME,33,50,34,10,94,278,124,133,535,157,-4.386267043,140.2938082
PAMEK,34,28,76,52,156,210,55,45,310,659,-4.382153482,140.0059239
NONGME,35,26,28,18,72,300,105,102,507,471,-4.244245356,140.0922362
BATANI,36,0,1,0,1,211,94,64,369,289,-4.077918359,140.1344843
OKBI,40,47,66,40,153,117,27,48,192,373,-4.610359737,140.4630272
ABOY,41,30,20,14,64,107,28,39,174,581,-4.243106001,140.5868919
OKBAB,42,96,30,30,156,427,81,59,567,1194,-4.524568352,140.5149367
TEIRAPLU,43,10,3,5,18,230,105,56,391,170,-3.915886642,140.3429715
YEFTA,44,19,9,4,32,66,27,32,125,402,-4.077950995,140.5238772
KIWIROK,50,124,71,46,241,309,48,61,418,642,-4.662778172,140.7726951
KIWIROK TIMUR,51,10,7,4,21,290,92,68,450,1965,-4.745586457,140.8392647
OKHIKA,53,54,55,45,154,106,8,21,135,2069,-4.658994658,140.6831585
OKLIP,54,101,58,34,193,116,27,37,180,2216,-4.772625609,140.7927315
WARASAMO,55,30,5,11,46,318,97,120,535,1867,-4.854038238,140.8958778
BATOM,60,303,137,78,518,498,48,130,676,535,-4.370315783,140.9095832
MURKIM,61,2,3,1,6,108,29,27,164,1430,-3.998135714,140.7522343
MOFINOP,62,87,52,25,164,150,31,57,238,847,-4.110726629,140.8877409
OKBEMTA,63,48,71,40,159,178,143,162,483,1096,-4.493012632,140.7924817
KANGGIME,10,276,172,109,557,819,345,244,1408,865,-3.653626936,138.3713709
WONIKI,11,234,156,109,499,939,373,258,1570,885,-3.686266238,138.2997735
NABUNAGE,12,233,178,150,561,1028,387,240,1655,1662,-3.650507142,138.4126816
GILUBANDU,13,104,40,25,169,1191,329,178,1698,1142,-3.629129927,138.3079459
WAKUO,14,124,59,47,230,173,54,78,305,944,-3.6812408,138.4209526
KARUBAGA,20,397,205,82,684,435,143,168,746,1088,-3.672989061,138.4876983
GOYAGE,21,261,135,69,465,268,56,58,382,1413,-3.735414003,138.4390348
WUNIN,22,260,143,123,526,317,141,112,570,1017,-3.624125364,138.5983766
KONDAGA,23,285,160,129,574,167,62,62,291,1136,-3.599892971,138.4513775
NELAWI,24,236,173,90,499,184,99,103,386,513,-3.652612753,138.4516407
KUARI,25,437,267,140,844,570,140,108,818,265,-3.700735887,138.4459096
BOKONDINI,30,247,135,103,485,344,151,162,657,251,-3.530071658,138.6495773
BOKONERI,31,250,126,68,444,278,115,107,500,1018,-3.665306951,138.647418
BEWANI,32,261,174,116,551,252,109,176,537,172,-3.387117922,138.6948136
KEMBU,40,355,146,60,561,440,221,191,852,181,-3.561263428,138.3685477
WINA,41,105,92,44,241,395,177,204,776,67,-3.562272622,138.2240007
UMAGI,42,175,108,49,332,553,140,111,804,1626,-3.443872608,138.1226764
PANAGA,43,95,38,15,148,232,80,53,365,725,-3.556737333,138.4538618
POGANERI,44,68,29,23,120,75,37,33,145,644,-3.429612258,138.2961864
KAMBONERI,45,38,31,11,80,68,51,52,171,583,-3.367641474,138.2503535
AIR GARAM,46,215,152,139,506,288,126,98,512,440,-3.28923053,138.0759067
DOW,47,75,32,17,124,32,7,9,48,1489,-3.392944057,138.4869135
WARI / TAIYEVE,48,82,34,23,139,23,6,13,42,815,-3.238805065,138.272657
EGIAM,49,10,4,2,16,20,13,18,51,1307,-3.300702093,138.2112357
NUNGGAWI,51,108,66,38,212,928,294,192,1414,243,-3.749483544,138.3608113
KUBU,60,139,65,86,290,219,98,118,435,36,-3.712595232,138.5049603
GEYA,70,214,80,39,333,148,84,79,311,925,-3.6866806,138.5521962
NUMBA,80,246,79,51,376,152,34,21,207,631,-3.593422961,138.53251
DUNDU,90,139,39,13,191,171,54,24,249,724,-3.494096317,138.2977664
GUNDAGI,100,370,297,204,871,351,141,126,618,606,-3.516809299,138.5181853
TIMORI,110,167,40,14,221,391,124,79,594,357,-3.616332175,138.489254
YUNERI,121,182,208,234,624,352,190,141,683,815,-3.483488307,138.4091568
TAGINERI,122,34,18,12,64,69,59,51,179,517,-3.384134275,138.1635283
DORMAN,123,10,5,1,16,3,0,17,20,278,-3.382582222,138.3903244
PANTAI TIMUR BAGIAN BARAT,21,481,176,85,742,52,32,99,183,495,-2.146509698,139.0376461
PANTAI TIMUR,22,324,142,116,582,13,6,30,49,334,-2.812911398,139.2393542
BONGGO,31,343,155,101,599,27,20,78,125,683,-2.325150552,139.4680373
BONGGO TIMUR,32,284,136,80,500,21,23,62,106,708,-2.382502734,139.7419837
TOR ATAS,40,163,58,41,262,46,15,34,95,607,-2.409754548,138.8392476
SARMI,50,416,157,94,667,45,28,75,148,725,-1.836799535,138.7448298
SARMI TIMUR,51,304,94,92,490,20,4,3,27,2481,-2.047062486,138.7976854
SARMI SELATAN,52,65,23,14,102,78,52,46,176,831,-2.029772498,138.6557191
PANTAI BARAT,60,216,96,45,357,53,19,66,138,1345,-1.799921908,138.3985177
APAWER HULU,61,29,12,15,56,141,65,72,278,661,-2.023049435,138.3928024
WEB,10,285,126,80,491,107,34,51,192,311,-3.632806149,140.8466814
TOWE HITAM,11,154,65,26,245,313,90,60,463,796,-3.832552852,140.8462053
SENGGI,20,279,71,41,391,87,39,90,216,318,-3.502930378,140.5815811
WARIS,30,322,137,100,559,86,30,50,166,397,-3.203730796,140.8732803
ARSO,40,1130,483,307,1920,203,92,266,561,251,-2.975988292,140.651982
ARSO TIMUR,41,391,176,102,669,72,35,55,162,350,-2.961159308,140.9170123
SKANTO,50,701,297,151,1149,29,33,134,196,487,-2.847142457,140.5238024
WAROPEN BAWAH,10,302,159,97,558,30,21,52,103,690,-2.253706026,136.3785633
INGGERUS,11,181,66,18,265,10,8,28,46,362,-2.750418463,136.4389372
UREIFAISEI,12,372,180,111,663,38,26,69,133,618,-2.235589647,136.5025023
OADATE,13,162,47,31,240,25,15,38,78,1183,-2.548440962,136.531502
WAPOGA,14,194,78,42,314,40,14,29,83,396,-2.918744153,136.3925954
MASIREI,20,147,45,32,224,5,9,13,27,492,-2.539787286,137.0147681
RISEI SAYATI,21,150,71,31,252,46,19,33,98,969,-2.563805453,136.7946048
DEMBA,22,237,107,48,392,36,22,37,95,651,-2.282839764,136.7010643
WALANI,30,0,0,0,0,403,151,136,690,286,-2.934148927,137.1504921
KIRIHI,40,0,0,0,0,204,81,77,362,622,-3.073174612,136.7926116
SUPIORI SELATAN,10,276,149,82,507,60,14,37,111,465,-0.789103216,135.571437
KEPULAUAN ARURI,11,622,216,135,973,51,61,98,210,681,-0.747491232,135.4506039
SUPIORI UTARA,20,205,83,52,340,9,16,31,56,509,-0.724159569,135.6238922
SUPIORI BARAT,21,230,88,50,368,40,41,43,124,766,-0.621349757,135.4505304
SUPIORI TIMUR,30,439,229,160,828,59,23,59,141,963,-0.772122951,135.7070346
WAROPEN ATAS,30,264,112,45,421,139,34,57,230,3022,-2.438591605,137.2516289
BENUKI,31,114,42,17,173,64,26,23,113,2147,-2.291666389,137.6150716
SAWAI,32,250,88,31,369,106,58,89,253,3429,-1.825959308,137.4946094
MAMBERAMO ILIR,40,197,104,51,352,28,25,60,113,2627,-1.845920878,137.977226
MAMBERAMO TENGAH,50,262,106,75,443,105,60,73,238,2634,-2.371659669,138.2958056
MAMBERAMO TENGAH TIMUR,60,150,66,31,247,191,38,33,262,6060,-2.716022219,138.012966
ROFAER,70,323,69,29,421,175,72,98,345,4212,-2.891952968,137.8920718
MAMBERAMO ULU,80,405,164,114,683,124,41,115,280,2536,-3.072390697,138.5799048
WOSAK,10,349,210,46,605,1273,583,561,2417,7848,-4.365187258,138.6753874
KENYAM,20,128,54,24,206,1169,428,344,1941,5753,-4.603126351,138.5392268
GESELMA,30,0,0,1,1,1903,838,687,3428,7420,-4.390125457,137.9078299
MAPENDUMA,40,46,31,5,82,1317,701,527,2545,5106,-4.38903101,138.2312139
MUGI,50,84,61,27,172,1599,494,369,2462,4359,-4.392202629,138.3770793
YIGI,60,244,186,111,541,2972,1423,1124,5519,1445,-4.228258903,138.3842825
MBUWA,70,108,66,50,224,2181,969,838,3988,3420,-4.239029273,138.4848983
GEAREK,80,310,152,82,544,1278,372,342,1992,4388,-4.60527211,138.7143499
MAKKI,10,1664,794,527,2985,2766,1193,904,4863,3306,-3.972883996,138.6316746
PIRIME,20,1906,980,473,3359,1119,568,707,2394,3716,-4.006081179,138.5243603
TIOM,30,2248,1348,697,4293,1371,725,1031,3127,5619,-3.908881024,138.2912859
BALINGGA,40,1703,829,412,2944,1083,489,590,2162,664,-4.111368969,138.3676862
KUYAWAGE,50,1457,770,369,2596,904,431,428,1763,2272,-4.063497086,137.9421181
MALAGAINERI,60,411,180,53,644,359,226,216,801,1960,-3.948246423,138.185799
TIOMNERI,70,1052,532,261,1845,719,411,445,1575,1664,-3.841977085,138.3202186
DIMBA,80,1710,533,181,2424,1318,383,263,1964,2366,-3.869353006,138.5116244
GAMELIA,90,937,282,116,1335,1091,498,382,1971,1878,-3.881628923,138.6264887
POGA,100,1287,456,69,1812,1084,476,344,1904,7507,-3.781731506,138.5211963
KOBAKMA,10,1205,481,224,1910,1917,817,975,3709,1904,-3.67601377,139.0965417
ILUGWA,20,358,77,21,456,90,57,61,208,1672,-3.850030197,138.9736235
KELILA,30,737,330,188,1255,568,203,246,1017,1329,-3.746940795,138.7069132
ERAGAYAM,40,572,205,61,838,650,260,212,1122,4771,-3.661586964,138.8577267
MEGAMBILIS,50,635,220,79,934,412,124,194,730,3414,-3.502097415,139.1180264
WELAREK,10,285,109,34,428,946,535,457,1938,4280,-3.947900637,139.5335372
APALAPSILI,20,758,332,178,1268,333,94,183,610,3676,-3.933605766,139.3014857
ABENAHO,30,1742,730,480,2952,2310,1102,1143,4555,1073,-3.871681031,139.1576064
ELELIM,40,732,331,170,1233,292,145,234,671,2711,-3.792747063,139.4180688
BENAWA,50,150,72,33,255,667,424,326,1417,598,-3.661737944,139.6238097
AGADUGUME,10,3,0,2,5,888,282,154,1324,743,-3.917749945,137.8467512
GOME,20,1034,310,171,1515,1792,748,716,3256,2576,-3.600853345,137.3631745
ILAGA,30,629,564,569,1762,828,481,343,1652,739,-4.036135372,137.5495569
SINAK,40,714,351,98,1163,2344,525,248,3117,2185,-3.813446672,137.7887679
POGOMA,50,45,47,33,125,2499,717,335,3551,1287,-3.698335733,137.7233361
WANGBE,60,178,64,30,272,302,190,309,801,2740,-3.893417708,137.4510558
BEOGA,70,639,422,158,1219,485,354,653,1492,3489,-3.829081278,137.3190296
DOUFO,80,103,25,2,130,273,100,95,468,2120,-3.263156657,137.2206727
SUKIKAI SELATAN,10,82,16,3,101,458,124,60,642,1035,-4.085363248,135.3662699
PIYAIYE,20,1068,278,94,1440,665,231,240,1136,2388,-3.948394461,135.4637835
MAPIA BARAT,30,280,47,34,361,219,64,95,378,2714,-4.101965076,135.7451229
MAPIA TENGAH,40,639,320,251,1210,473,189,313,975,2390,-4.098983666,135.8170644
MAPIA,50,425,122,95,642,455,107,83,645,1187,-3.890006651,135.8786405
DOGIYAI,60,989,480,349,1818,558,168,196,922,1737,-4.018646791,135.9712894
KAMU SELATAN,70,1054,492,616,2162,769,217,341,1327,1183,-4.16785106,136.035519
KAMU,80,813,254,159,1226,638,151,105,894,843,-4.020918587,136.0536493
KAMU TIMUR,90,454,152,103,709,210,60,56,326,1039,-3.987705533,136.166477
KAMU UTARA,100,1021,315,168,1504,602,128,154,884,7196,-3.889348276,136.1039893
HOMEYO,10,570,294,198,1062,722,358,572,1652,3438,-3.781061405,136.8194984
SUGAPA,20,520,184,135,839,792,272,487,1551,2128,-3.809337943,137.0359822
HITADIPA,30,130,63,69,262,533,164,228,925,1944,-3.521421661,136.9052884
AGISIGA,40,129,57,30,216,869,341,311,1521,1146,-3.655235376,137.0919156
BIANDOGA,50,86,21,8,115,806,181,81,1068,4585,-3.387357351,136.5691096
WANDAI,60,151,84,139,374,198,116,155,469,1718,-3.724316332,136.6537632
KAPIRAYA,10,0,0,0,0,566,204,269,1039,5583,-4.186344057,136.1713573
TIGI BARAT,20,1962,626,446,3034,2550,660,952,4162,4588,-4.092957939,136.2037228
TIGI,30,760,321,308,1389,1237,327,485,2049,,-4.059145914,136.274315
TIGI TIMUR,40,676,310,364,1350,352,132,294,778,,-4.093889536,136.5041425
BOWOBADO,50,0,0,0,0,1264,435,245,1944,,-4.214467942,136.408763
MUARA TAMI,10,572,243,161,976,64,33,73,170,1146,-2.692612599,140.9008129
ABEPURA,20,2265,994,672,3931,209,100,345,654,4585,-2.666396265,140.7112919
HERAM,21,817,351,281,1449,91,37,141,269,1718,-2.637056573,140.6399228
JAYAPURA SELATAN,30,2787,1119,855,4761,279,139,404,822,5583,-2.556888597,140.6712852
JAYAPURA UTARA,40,2290,1003,664,3957,196,116,319,631,4588,-2.510468693,140.6863851
